g_12inun	(Genesis) 12 合 1 (Unl) [!]
g_3in1ro	(Genesis) 3 合 1 暴力摩托 - 女小精灵 - 立体方块 [p1][!]
g_3in1fl	(Genesis) 3 合 1 永恒追求 - 世界足球锦标赛 - 92 世界杯 [p1][!]
g_4in1pb	(Genesis) 4 合 1 [p1][!]
g_6pakus	(Genesis) 6 合 1 (美版)
g_aressh	(Genesis) A 行列车 MD (日版)
g_eahock	(Genesis) EA 曲棍球联赛 (欧版)
g_eahoc1	(Genesis) EA 曲棍球联赛 (日版)
g_easpor	(Genesis) EA 赛车联赛 (欧版)
g_f1wc	(Genesis) F1 - 世界锦标赛 (欧版)
g_f1wcb	(Genesis) F1 - 世界锦标赛 (欧版) (Beta)
g_f1circ	(Genesis) F1 赛车 MD (日版)
g_f22	(Genesis) F-22 拦截机 (美版, 欧版) (September 1991)
g_f22_realdump	(Genesis) F-22 拦截机 (美版, 欧版) (September 1991) (proper dump)
g_fifa	(Genesis) FIFA 国际足球 (美版, 欧版) (En,Fr,De,Es)
g_fi2k	(Genesis) FIFA 足球 2000 金版 (Unl) (M6) [!]
g_fi95	(Genesis) FIFA 足球 95 (美版, 欧版) (En,Fr,De,Es)
g_fi96	(Genesis) FIFA 足球 96 (美版, 欧版) (En,Fr,De,Es,It,Sv)
g_fi97	(Genesis) FIFA 足球 97 (美版, 欧版) (En,Fr,De,Es,It,Sv)
g_fi97_realdump	(Genesis) FIFA 足球 97 (美版, 欧版) (En,Fr,De,Es,It,Sv) (proper dump)
g_fi98	(Genesis) FIFA 足球 98 - 通向世界杯之路 (欧版) (En,Fr,Es,It,Sv)
g_futbol	(Genesis) FIFA 足球 98 (Unl)
g_fi99	(Genesis) FIFA 足球 99 (R) [!]
g_jl_ps	(Genesis) J. 联盟超级足球 (日版) (v1.0)
g_jl_psa	(Genesis) J. 联盟超级足球 (日版) (v1.3)
g_jl_ps2	(Genesis) J. 联盟超级足球 2 (日版)
g_jl_fs	(Genesis) J. 联盟超级足球之最后一战 (日版)
g_jl_pf	(Genesis) J. 联盟完美射手完全版 (日版)
g_jl	(Genesis) J. 联盟足球 (日版)
g_nbapro	(Genesis) NBA 超级篮球赛 '94 (日版)
g_nbashb	(Genesis) NBA 灌篮赛 '94 (美版) (Beta)
g_nbash	(Genesis) NBA 灌篮赛 '94 (美版, 欧版)
g_nbl95	(Genesis) NBA 实况转播 95 (美版, 欧版)
g_nbal96	(Genesis) NBA 实况转播 96 (美版, 欧版)
g_nbal97	(Genesis) NBA 实况转播 97 (美版, 欧版)
g_nbal98	(Genesis) NBA 实况转播 98 (美版)
g_ncaafo	(Genesis) NCAA 大学橄榄球联赛 (美版)
g_ncaafi	(Genesis) NCAA 大学篮球总决赛 (美版)
g_nh94_realdump	(Genesis) NHL '94 (美版, 欧版) (proper dump)
g_tsbb	(Genesis) Tecmo 超级 NBA 篮球 (美版)
g_tsbbj	(Genesis) Tecmo 超级 NBA 篮球 (日版)
g_tsb	(Genesis) Tecmo 超级板球 (美版) (October 1993)
g_tsbo	(Genesis) Tecmo 超级板球 (美版) (September 1993)
g_tsbj	(Genesis) Tecmo 超级板球 (日版)
g_tsb2	(Genesis) Tecmo 超级板球 II - 特别版 (美版)
g_tsb2j	(Genesis) Tecmo 超级板球 II - 特别版 (日版)
g_tsb3	(Genesis) Tecmo 超级板球 III - 最终版 (美版)
g_tecmos	(Genesis) Tecmo 超级棒球 (美版)
g_vf2	(Genesis) VR 战士 2 (美版, 欧版)
g_addam2	(Genesis) 阿达姆斯家庭 (美版) (Beta)
g_addam	(Genesis) 阿达姆斯家庭 (美版, 欧版)
g_afv	(Genesis) 阿达姆斯家庭 (欧版) (En,Fr,De)
g_andre2	(Genesis) 阿加斯网球 (美版)
g_andre1	(Genesis) 阿加斯网球 (美版) (Beta)
g_andrea	(Genesis) 阿加斯网球 (欧版)
g_aladd3	(Genesis) 阿拉丁 (美版)
g_aladd2	(Genesis) 阿拉丁 (美版) (Beta)
g_aladdi	(Genesis) 阿拉丁 (欧版)
g_aladd1	(Genesis) 阿拉丁 (日版)
g_alad2	(Genesis) 阿拉丁 II (Unl)
g_arcus	(Genesis) 阿鲁卡冒险 (美版)
g_arcusj	(Genesis) 阿鲁卡冒险 (日版)
g_arnold	(Genesis) 阿诺德高尔夫锦标赛 (美版, 欧版)
g_aster1	(Genesis) 阿斯特瑞克斯 - 大救援 (美版)
g_asteri	(Genesis) 阿斯特瑞克斯 - 大救援 (欧版) (En,Fr,De,Es,It)
g_astepg	(Genesis) 阿斯特瑞克斯 - 上帝之力 (欧版) (En,Fr,De,Es)
g_shdwr	(Genesis) 暗之追迹者 (美版)
g_shdwrj	(Genesis) 暗之追迹者 (日版)
g_austra	(Genesis) 澳大利亚橄榄球 (欧版)
g_barbi1	(Genesis) 芭比 - 假日冒险 (美版) (Proto)
g_bahamu	(Genesis) 巴哈姆特战记 (日版)
g_barney	(Genesis) 巴尼寻宝 (美版)
g_bassma	(Genesis) 巴斯钓鱼经典版 (美版)
g_espnba	(Genesis) 棒球之夜 (美版)
g_twocr1	(Genesis) 暴力克星 (美版)
g_twocru	(Genesis) 暴力克星 (欧版)
g_crudeb	(Genesis) 暴力克星 (日版)
g_roadra	(Genesis) 暴力摩托 (美版, 欧版)
g_rrsh3	(Genesis) 暴力摩托 3 (美版, 欧版)
g_rrsh2b	(Genesis) 暴力摩托 II (美版, 欧版)
g_rrsh2a	(Genesis) 暴力摩托 II (美版, 欧版) (v1.2)
g_rrsh2	(Genesis) 暴力摩托 II (日版)
g_billwa	(Genesis) 比尔渥休足球 (美版, 欧版)
g_bill95	(Genesis) 比尔渥休足球 '95 (美版)
g_batmrd	(Genesis) 蝙蝠侠 - 爵克的复仇 (美版)
g_batma2	(Genesis) 蝙蝠侠 (美版)
g_batman	(Genesis) 蝙蝠侠 (欧版)
g_batma1	(Genesis) 蝙蝠侠 (日版)
g_batmrt	(Genesis) 蝙蝠侠归来 (世界版)
g_adven1	(Genesis) 蝙蝠侠与罗宾的冒险 (美版)
g_advent	(Genesis) 蝙蝠侠与罗宾的冒险 (欧版)
g_musham	(Genesis) 变形战机 (美版)
g_buckro	(Genesis) 别克罗杰 - 最终审判 (美版, 欧版)
g_aahari	(Genesis) 播磨滩相扑 (日版)
g_aokioo	(Genesis) 苍狼与白鹿 - 成吉思汗 (日版)
g_sb2020	(Genesis) 超级棒球 2020 (美版, 欧版)
g_2020to	(Genesis) 超级棒球 2020 (日版)
g_proyak	(Genesis) 超级棒球 '91 (日版)
g_superd	(Genesis) 超级大战略 (日版)
g_suphyu	(Genesis) 超级海德 (美版)
g_suphy	(Genesis) 超级海德 (欧版)
g_suphyj	(Genesis) 超级海德 (日版)
g_ssf2u	(Genesis) 超级街头霸王 II - 新的来者 (美版)
g_ssf2	(Genesis) 超级街头霸王 II - 新的来者 (欧版)
g_superk	(Genesis) 超级劲射足球 (欧版)
g_barbie	(Genesis) 超级名模芭比 (美版)
g_smgp	(Genesis) 超级摩纳哥GP赛车 (美版) (En,Ja)
g_smgpj	(Genesis) 超级摩纳哥GP赛车 (日版) (En,Ja)
g_smgpb	(Genesis) 超级摩纳哥GP赛车 (日版, 欧版) (En,Ja)
g_smgpa	(Genesis) 超级摩纳哥GP赛车 (日版, 欧版) (En,Ja) (Rev A)
g_asmgp	(Genesis) 超级摩纳哥GP赛车 II (美版) (En,Ja)
g_asmgpj	(Genesis) 超级摩纳哥GP赛车 II (日版, 欧版) (En,Ja)
g_supero	(Genesis) 超级四驱车 (美版, 欧版)
g_chouky	(Genesis) 超球界 (日版)
g_rentah	(Genesis) 出租英雄 (日版)
g_crusad	(Genesis) 创世战士 (美版)
g_jstria	(Genesis) 丛林激战直升机 (美版) (Beta)
g_jstrik	(Genesis) 丛林激战直升机 (美版, 欧版)
g_jstrib	(Genesis) 丛林激战直升机 (日版)
g_darwin	(Genesis) 达尔文 4081 (日版, 韩国版)
g_unchw2	(Genesis) 大航海时代 - 新大陆 (美版)
g_daik2	(Genesis) 大航海时代 II (日版)
g_fastes	(Genesis) 大赛车 (日版)
g_collnc	(Genesis) 大学美式足球冠军赛 (美版)
g_colln2	(Genesis) 大学美式足球冠军赛 II (美版)
g_disney	(Genesis) 迪斯尼幻想乐园 (欧版)
g_operat	(Genesis) 第二次世界大战 1939-45 (美版)
g_action	(Genesis) 动作 52合1 (美版) (Alt) (Unl)
g_actio1	(Genesis) 动作 52合1 (美版) (Unl)
g_nbaa	(Genesis) 动作 NBA (美版)
g_naa95	(Genesis) 动作 NBA '95 (美版, 欧版)
g_tougio	(Genesis) 斗技王 (日版)
g_libert	(Genesis) 独立战争 (美版)
g_coachk	(Genesis) 杜克大学篮球 (美版)
g_cvani2	(Genesis) 恶魔城 - 新的时代 (欧版)
g_cvani1	(Genesis) 恶魔城 - 新的时代 (欧版) (Beta)
g_cvania	(Genesis) 恶魔城 - 血族 (美版)
g_aerot2	(Genesis) 飞翔蝙蝠 (美版)
g_aeroth	(Genesis) 飞翔蝙蝠 (欧版)
g_aero2u	(Genesis) 飞翔蝙蝠 2 (美版)
g_aero2	(Genesis) 飞翔蝙蝠 2 (欧版)
g_aworgj	(Genesis) 浮游战士 (日版) (SegaNet)
g_blades	(Genesis) 复仇之刃 (美版, 欧版)
g_unnece	(Genesis) 橄榄球 95 (美版)
g_bimini	(Genesis) 高速竞艇 (美版)
g_gemfir	(Genesis) 古代战争 (美版)
g_beasw	(Genesis) 怪兽摔角 (美版)
g_maste1	(Genesis) 怪兽之主 (美版)
g_master	(Genesis) 怪兽之主 (日版)
g_tnnbas	(Genesis) 冠军钓鱼 (美版)
g_shnfb	(Genesis) 光明力量 - 诸神之遗产 (日版)
g_shnf	(Genesis) 光明力量 (美版)
g_shnfa	(Genesis) 光明力量 (美版) (Beta)
g_shf2j	(Genesis) 光明力量 II - 古代封印 (日版)
g_shf2u	(Genesis) 光明力量 II (美版)
g_shf2	(Genesis) 光明力量 II (欧版)
g_light2	(Genesis) 光明十字军 (韩国版) (En,Ko)
g_light4	(Genesis) 光明十字军 (美版)
g_lightc	(Genesis) 光明十字军 (欧版) (En,Fr,De,Es)
g_light1	(Genesis) 光明十字军 (日版)
g_sitdb	(Genesis) 光明与黑暗 (巴西版)
g_sitd	(Genesis) 光明与黑暗 (美版, 欧版)
g_shinso	(Genesis) 光明与黑暗 (日版)
g_shinin	(Genesis) 光明与黑暗 (日版)
g_story8	(Genesis) 光之继承者 - Hikari o Tsugumono (日版)
g_story1	(Genesis) 光之继承者 (Germany)
g_story7	(Genesis) 光之继承者 (Spain)
g_legen1	(Genesis) 光之继承者 (法文版)
g_story3	(Genesis) 光之继承者 (韩国版)
g_storyo	(Genesis) 光之继承者 (欧版)
g_story2	(Genesis) 光之继承者 (日版) (Beta) [b]
g_crying	(Genesis) 海底战争 - 亚生命战争 (日版)
g_aquati	(Genesis) 海洋动物运动会 (美版, 欧版)
g_aerobs	(Genesis) 航空霸业 - 超音速 (美版)
g_airman	(Genesis) 航空霸业 - 在天空翱翔 (日版)
g_aerobi	(Genesis) 航空霸业 (美版)
g_airmas	(Genesis) 航空霸业 II - 航空王 (日版)
g_tnnout	(Genesis) 户外钓鱼 '96 (美版)
g_phan22	(Genesis) 幻影 2040 (美版)
g_phanto	(Genesis) 幻影 2040 (欧版)
g_castl	(Genesis) 幻影堡垒 - 不可思议的御城大冒险 (美版, 欧版)
g_castlj	(Genesis) 幻影堡垒 - 不可思议的御城大冒险 (日版)
g_royalb	(Genesis) 皇家血统 (日版)
g_backt1	(Genesis) 回到未来 III (美版)
g_backto	(Genesis) 回到未来 III (欧版)
g_dukenu	(Genesis) 毁灭公爵 3D (巴西版)
g_contra	(Genesis) 魂斗罗 - 铁血兵团 (美版, 韩国版)
g_probot	(Genesis) 魂斗罗 - 铁血兵团 (欧版)
g_contr1	(Genesis) 魂斗罗 - 铁血兵团 (日版)
g_rocke2	(Genesis) 火箭骑士历险记 (美版)
g_rocket	(Genesis) 火箭骑士历险记 (欧版)
g_rocke1	(Genesis) 火箭骑士历险记 (日版)
g_gunst3	(Genesis) 火枪英雄 (美版)
g_gunsta	(Genesis) 火枪英雄 (欧版)
g_gunst2	(Genesis) 火枪英雄 (日版)
g_gunst1	(Genesis) 火枪英雄 (日版) (Sample)
g_tazemu	(Genesis) 火星逃脱者 (美版)
g_tazem	(Genesis) 火星逃脱者 (欧版)
g_kidouk	(Genesis) 机动警察 (日版)
g_vixenj	(Genesis) 机甲神兵 (日版)
g_batttc	(Genesis) 机甲争霸 (美版)
g_riseof	(Genesis) 机器人格斗 (欧版)
g_eswatc	(Genesis) 机械警察 - 围困之城 (美版)
g_pacifi	(Genesis) 激战太平洋 (美版)
g_teitok	(Genesis) 激战太平洋 (日版)
g_blast	(Genesis) 疾风战车 2 (美版)
g_blastb	(Genesis) 疾风战车 2 (美版) (Beta)
g_airbus	(Genesis) 疾风战机 (美版)
g_aerobl	(Genesis) 疾风战机 (日版)
g_espsp	(Genesis) 极速世界 (美版)
g_califo	(Genesis) 加州游戏 (美版, 欧版)
g_arcade	(Genesis) 街机合集 (美版, 欧版)
g_sf2u	(Genesis) 街头霸王 II' - 特别冠军版 (美版)
g_sf2	(Genesis) 街头霸王 II' - 特别冠军版 (欧版)
g_sf2p	(Genesis) 街头霸王 II' Plus (日版, 亚洲版)
g_ballja	(Genesis) 杰克钢球 (日版, 欧版)
g_jackni	(Genesis) 杰克尼克劳斯高尔夫 (美版, 欧版)
g_classi	(Genesis) 经典 4 合 1 (欧版)
g_berens	(Genesis) 卷毛熊露营冒险 (美版)
g_chelno	(Genesis) 卡洛夫 (日版)
g_besto1	(Genesis) 空手道 (美版)
g_bestof	(Genesis) 空手道 (欧版)
g_airdv	(Genesis) 空中霸王 (美版)
g_airdvj	(Genesis) 空中霸王 (日版)
g_exosq2	(Genesis) 空中战警 (美版)
g_exosq1	(Genesis) 空中战警 (美版) (Beta)
g_exosqu	(Genesis) 空中战警 (欧版)
d_hirea	(Genesis) 恐龙战士 (Prototype - Apr 26, 1993)
d_hireb	(Genesis) 恐龙战士 (Prototype - Apr 27, 1993)
d_hirec	(Genesis) 恐龙战士 (Prototype - May 02, 1993)
d_hire	(Genesis) 恐龙战士 (美版)
g_telsta	(Genesis) 快乐棒球 (日版)
g_archri	(Genesis) 篮球 - 街机游戏 (美版, 欧版)
g_beyonu	(Genesis) 雷神传说 (美版)
g_blocko	(Genesis) 立体方块 (世界版)
g_vmana	(Genesis) 粒子斗士 (Beta)
g_vmanb	(Genesis) 粒子斗士 (Prototype - Jul 24, 1995)
g_vmanc	(Genesis) 粒子斗士 (美版) (Beta)
g_vman	(Genesis) 粒子斗士 (美版, 欧版)
g_hybri	(Genesis) 联合阵线 (日版)
g_beavi2	(Genesis) 两个傻瓜 (美版)
g_beavis	(Genesis) 两个傻瓜 (欧版)
g_688att	(Genesis) 猎杀潜艇 (美版, 欧版)
g_zeroto	(Genesis) 零号特警 (美版, 欧版)
g_artof2	(Genesis) 龙虎之拳 (美版)
g_artoff	(Genesis) 龙虎之拳 (欧版)
g_ryuuko	(Genesis) 龙虎之拳 (日版)
g_alisi2	(Genesis) 龙骑士 (美版)
g_alisia	(Genesis) 龙骑士 (欧版)
g_alisi1	(Genesis) 龙骑士 (日版)
g_dungeo	(Genesis) 龙与地下城 - 永恒的太阳战士 (美版, 欧版)
g_warri1	(Genesis) 罗马勇士 II (美版)
g_caes2	(Genesis) 罗马勇士 II (日版)
g_rockm1	(Genesis) 洛克人 (日版)
g_rockma	(Genesis) 洛克人 (日版) (Alt)
g_megama	(Genesis) 洛克人大合集 (欧版)
g_bob	(Genesis) 蚂蚁战士 (美版, 欧版)
g_pulsem	(Genesis) 脉冲超人 (日版)
g_comix1	(Genesis) 漫画地带 (E) (Prototype - Jun 28, 1995)
g_comix3	(Genesis) 漫画地带 (K) (Prototype - Jun 09, 1995)
g_comix4	(Genesis) 漫画地带 (Prototype - Jul 12, 1995 - FULSCR)
g_comix5	(Genesis) 漫画地带 (Prototype - Jul 12, 1995)
g_comix6	(Genesis) 漫画地带 (Prototype - Jun 01, 1995 - B)
g_comix7	(Genesis) 漫画地带 (Prototype - Jun 01, 1995 - C)
g_comix8	(Genesis) 漫画地带 (Prototype - Jun 01, 1995 - D)
g_comix9	(Genesis) 漫画地带 (Prototype - Jun 01, 1995)
g_comix	(Genesis) 漫画地带 (欧版)
g_comix2	(Genesis) 漫画地带 (日版)
g_monste	(Genesis) 冒险世界 IV (日版)
g_colleg	(Genesis) 美国大学足球 '96 (美版)
g_coll97	(Genesis) 美国大学足球 '97 (美版)
g_americ	(Genesis) 美国夺标 (美版)
g_beauty	(Genesis) 美女与野兽 - 美女的追求 (美版)
g_beaurb	(Genesis) 美女与野兽 - 野兽之怒吼 (美版)
g_arielt	(Genesis) 美人鱼 (美版, 欧版)
g_bishou	(Genesis) 美少女战士 (日版)
g_nfl94	(Genesis) 美式足球 '94 (美版)
g_nfl94j	(Genesis) 美式足球 '94 (日版)
g_nfl95	(Genesis) 美式足球 '95 (美版, 欧版)
g_nfl98	(Genesis) 美式足球 '98 (美版)
g_warson	(Genesis) 梦幻模拟战 (美版)
g_langri	(Genesis) 梦幻模拟战 (日版)
g_lang2b	(Genesis) 梦幻模拟战 II (日版)
g_lang2a	(Genesis) 梦幻模拟战 II (日版) (v1.1)
g_lang2	(Genesis) 梦幻模拟战 II (日版) (v1.2)
g_pstr4j	(Genesis) 梦幻之星 - Sennenki no Owari ni (日版)
g_pstr2j	(Genesis) 梦幻之星 II - Kaerazaru Toki no Owari ni (日版)
g_pstr2a	(Genesis) 梦幻之星 II (巴西版)
g_pstr2b	(Genesis) 梦幻之星 II (美版, 欧版)
g_pstr2	(Genesis) 梦幻之星 II (美版, 欧版) (Rev A)
g_pstr3	(Genesis) 梦幻之星 III - 时之继承者 (巴西版)
g_pstr3a	(Genesis) 梦幻之星 III - 时之继承者 (美版, 欧版)
g_pstr3b	(Genesis) 梦幻之星 III - 时之继承者 (日版)
g_pstr4	(Genesis) 梦幻之星 IV (美版)
g_lands2	(Genesis) 秘境魔宝 (德文版)
g_lands4	(Genesis) 秘境魔宝 (法文版)
g_lands1	(Genesis) 秘境魔宝 (美版)
g_landst	(Genesis) 秘境魔宝 (美版) (Beta)
g_lands5	(Genesis) 秘境魔宝 (欧版)
g_lands3	(Genesis) 秘境魔宝 (日版)
g_madoum	(Genesis) 魔导物语 I (日版)
g_colum1	(Genesis) 魔法宝石 (世界版)
g_column	(Genesis) 魔法宝石 (世界版) (v1.1)
g_cols3	(Genesis) 魔法宝石 III - Revenge of Columns (美版)
g_cols3a	(Genesis) 魔法宝石 III - Taiketsu! Columns World (日版, 韩国版)
g_mighta	(Genesis) 魔法门 - 世界之门 (美版, 欧版)
g_drrob2	(Genesis) 魔法气泡外传 (美版)
g_drrob1	(Genesis) 魔法气泡外传 (美版) (Beta)
g_drrobo	(Genesis) 魔法气泡外传 (欧版)
g_matenn	(Genesis) 魔天的创灭 (日版)
g_sora	(Genesis) 怒之铁拳 (世界版)
g_sor	(Genesis) 怒之铁拳 (世界版) (Rev A)
g_sor2	(Genesis) 怒之铁拳 2 (美版)
g_sor3u	(Genesis) 怒之铁拳 3 (美版)
g_sor3	(Genesis) 怒之铁拳 3 (欧版)
g_sor3a	(Genesis) 怒之铁拳 3 (亚洲版)
g_bk2b	(Genesis) 怒之铁拳 II (日版) (Beta)
g_bk2	(Genesis) 怒之铁拳 II (日版, 欧版)
g_bk3	(Genesis) 怒之铁拳 III (日版)
g_europe	(Genesis) 欧洲杯足球 (欧版)
g_pgaeur	(Genesis) 欧洲职业高尔夫球赛 (美版, 欧版)
g_pebbl1	(Genesis) 培柏海岸高尔夫球场 (美版)
g_pebble	(Genesis) 培柏海岸高尔夫球场 (欧版)
g_elimin	(Genesis) 平衡战机 (日版)
g_cools3	(Genesis) 七喜小子 (美版)
g_cools2	(Genesis) 七喜小子 (美版) (Beta)
g_coolsp	(Genesis) 七喜小子 (欧版)
g_wolu	(Genesis) 奇幻世界 - 米老鼠与唐老鸭 (美版, 韩国版)
g_wol	(Genesis) 奇幻世界 - 米老鼠与唐老鸭 (欧版)
g_kishid	(Genesis) 骑士传说 (日版)
g_ejimu	(Genesis) 蚯蚓战士 (美版)
g_ejim	(Genesis) 蚯蚓战士 (欧版)
g_ejim2u	(Genesis) 蚯蚓战士 2 (美版)
g_ejim2	(Genesis) 蚯蚓战士 2 (欧版)
g_ballzd	(Genesis) 球人大乱斗 (美版, 欧版)
g_nhlhoc	(Genesis) 曲棍球 (美版)
g_nhl94	(Genesis) 曲棍球赛 '94 (美版, 欧版)
g_nhl95	(Genesis) 曲棍球赛 '95 (美版, 欧版)
g_nhl96	(Genesis) 曲棍球赛 '96 (美版, 欧版)
g_nhl97	(Genesis) 曲棍球赛 '97 (美版, 欧版)
g_nhl98	(Genesis) 曲棍球赛 '98 (美版)
g_elit95	(Genesis) 曲棍球赛季 95 (Sweden)
g_elit96	(Genesis) 曲棍球赛季 96 (Sweden)
g_primet	(Genesis) 全程赛 '97 (美版)
g_kickbo	(Genesis) 拳击 (日版, 韩国版)
g_janout	(Genesis) 雀皇登龙门 (J) [!]
g_janou1	(Genesis) 雀皇登龙门 (日版)
g_3ninja	(Genesis) 忍杀三人组 (美版)
g_tmhshj	(Genesis) 忍者神龟 - 大进击 (日版)
g_tmhshu	(Genesis) 忍者神龟 - 史雷德回归 (美版)
g_tmhsh	(Genesis) 忍者神龟 - 史雷德回归 (欧版)
g_r3k2	(Genesis) 三国志 II (美版)
g_sangok	(Genesis) 三国志 II (日版)
g_r3k3	(Genesis) 三国志 III - 龙的复活 (美版)
g_sango1	(Genesis) 三国志 III (日版)
g_sango2	(Genesis) 三国志列传 - 乱世群英 (日版)
g_sanguo	(Genesis) 三国志列传 - 乱世群英 (中文版)
g_anima1	(Genesis) 三只笨鼠 (美版)
g_animan	(Genesis) 三只笨鼠 (欧版) (En,Fr,De)
g_dstrk	(Genesis) 沙漠风暴 (美版, 欧版)
g_tfiii	(Genesis) 闪电出击 III (日版, 美版)
g_tfiv	(Genesis) 闪电出击 IV (欧版)
g_tfivj	(Genesis) 闪电出击 IV (日版)
g_wbmw	(Genesis) 神奇男孩在魔界 (美版, 欧版)
g_biohzb	(Genesis) 生化战机 (美版) (Beta)
g_biohz	(Genesis) 生化战机 (美版, 欧版)
g_espnf	(Genesis) 实况曲棍球 (美版)
g_16zhan	(Genesis) 十六张麻将 (中文版) (Unl)
g_vermil	(Genesis) 石中剑 (日版)
g_16tons	(Genesis) 世嘉频道 (SN) (GNKO) (日版) [!]
g_16tjap	(Genesis) 世嘉频道 (日版) (SegaNet)
g_worldt	(Genesis) 世界杯 (美版)
g_wsb98	(Genesis) 世界系列棒球 '98 (美版)
g_altere	(Genesis) 兽王记 (美版, 欧版)
g_juuou1	(Genesis) 兽王记 (日版)
g_juuouk	(Genesis) 兽王记 (日版) (v1.1)
g_dd	(Genesis) 双截龙 (美版, 欧版)
g_sonicb	(Genesis) 索尼克 (W) (REV00) [p5][!]
g_sonic	(Genesis) 索尼克 (美版, 欧版)
g_sonica	(Genesis) 索尼克 (日版, 韩国版)
g_soni2b	(Genesis) 索尼克 2 (Beta 4 - Sep 18, 1992, 16.26)
g_soni2c	(Genesis) 索尼克 2 (Beta 5 - Sep 21, 1992, 12.06)
g_soni2d	(Genesis) 索尼克 2 (Beta 6 - Sep 22, 1992, 18.47)
g_soni2e	(Genesis) 索尼克 2 (Beta 6 - Sep 22, 1992, 19.42)
g_soni2f	(Genesis) 索尼克 2 (Beta 7 - Sep 24, 1992, 09.26)
g_soni2g	(Genesis) 索尼克 2 (Beta 8 - Sep 24, 1992, 19.27)
g_soni2h	(Genesis) 索尼克 2 (Prototype) [!]
g_soni2i	(Genesis) 索尼克 2 (W) (REV01a) [!]
g_soni2j	(Genesis) 索尼克 2 (W) (REVSC02)
g_soni2a	(Genesis) 索尼克 2 (世界版)
g_soni2k	(Genesis) 索尼克 2 (世界版) (Beta)
g_soni2	(Genesis) 索尼克 2 (世界版) (Rev A)
g_soni3a	(Genesis) 索尼克 3 (Argentinian Pirate)
g_soni3	(Genesis) 索尼克 3 (美版)
g_soni3b	(Genesis) 索尼克 3 (欧版)
g_soni3c	(Genesis) 索尼克 3 (日版, 韩国版)
g_son3c	(Genesis) 索尼克 3C (Prototype 0408 - Apr 08, 1994, 17.29)
g_son3ca	(Genesis) 索尼克 3C (Prototype 0517 - May 17, 1994, 17.08)
g_s3d	(Genesis) 索尼克 3D (美版, 欧版)
g_sspind	(Genesis) 索尼克弹珠台 (美版)
g_sspinb	(Genesis) 索尼克弹珠台 (美版) (Alt)
g_sspinc	(Genesis) 索尼克弹珠台 (美版) (Beta)
g_sspin	(Genesis) 索尼克弹珠台 (欧版)
g_sspina	(Genesis) 索尼克弹珠台 (日版)
g_compa	(Genesis) 索尼克合集 (美版, 欧版) (v1.1)
g_comp	(Genesis) 索尼克合集 (欧版)
g_scrack	(Genesis) 索尼克与疯狂小尾巴 (日版) (Proto)
g_ska	(Genesis) 索尼克与纳克鲁斯 (Prototype 0525 - May 25, 1994, 15.28)
g_skb	(Genesis) 索尼克与纳克鲁斯 (Prototype 0606 - Jun 06, 1994, 10.02)
g_skc	(Genesis) 索尼克与纳克鲁斯 (Prototype 0608 - Jun 08, 1994, 05.03)
g_skd	(Genesis) 索尼克与纳克鲁斯 (Prototype 0610 - Jun 10, 1994, 07.49)
g_ske	(Genesis) 索尼克与纳克鲁斯 (Prototype 0612 - Jun 12, 1994, 18.27)
g_skf	(Genesis) 索尼克与纳克鲁斯 (Prototype 0618 - Jun 18, 1994, 09.15)
g_skg	(Genesis) 索尼克与纳克鲁斯 (Prototype 0619 - Jun 19, 1994, 08.18)
g_sk	(Genesis) 索尼克与纳克鲁斯 (世界版)
g_knuckl	(Genesis) 索尼克与纳克鲁斯 2 (Prototype 0524 - May 27, 1994, 10.46)
g_sks1	(Genesis) 索尼克与纳克鲁斯 加强版 + 索尼克 (世界版)
g_sks2	(Genesis) 索尼克与纳克鲁斯 加强版 + 索尼克 2 (世界版)
g_sks3	(Genesis) 索尼克与纳克鲁斯 加强版 + 索尼克 3 (世界版)
g_spacef	(Genesis) 太空蚂蚁战士 (日版)
g_awspro	(Genesis) 太空足球 (美版)
g_nhktai	(Genesis) 太平记 (日版)
g_troyai	(Genesis) 特洛伊.阿卡曼的美式足球 (美版)
g_laruss	(Genesis) 托尼棒球 95 (美版, 澳洲版)
g_toeja1	(Genesis) 外星双傻 (世界版)
g_toejam	(Genesis) 外星双傻 (世界版) (Rev A)
g_micha1	(Genesis) 外星战将 - 麦可杰克森月球漫步 (世界版)
g_michae	(Genesis) 外星战将 - 麦可杰克森月球漫步 (世界版) (Rev A)
g_aliens	(Genesis) 外星战士 (欧版)
g_alien2	(Genesis) 外星战士 (日版)
g_advem1	(Genesis) 万能麦斯 (美版)
g_advemm	(Genesis) 万能麦斯 (欧版)
g_skinga	(Genesis) 王国巫师 (美版)
g_sking	(Genesis) 王国巫师 (美版) (v1.1)
g_sorcer	(Genesis) 王国巫师 (日版)
g_europa	(Genesis) 王者雄师 (日版)
g_aweso	(Genesis) 威鼠闯天关 (美版)
g_awesob	(Genesis) 威鼠闯天关 (美版) (Beta)
g_micma	(Genesis) 微型机车 (C)
g_micm	(Genesis) 微型机车 (美版, 欧版)
g_micmb	(Genesis) 微型机车 (美版, 欧版) (Alt)
g_micmc	(Genesis) 微型机车 (美版, 欧版) (MDMM ACD3)
g_micm2a	(Genesis) 微型机车 2 - 超级联赛 (欧版) (J-Cart)
g_micm2	(Genesis) 微型机车 2 - 超级联赛 (欧版) (J-Cart) (Alt)
g_mic96	(Genesis) 微型机车 96 (V1.1) (E)
g_mic96b	(Genesis) 微型机车 96 (欧版) (v1.1) (J-Cart)
g_mmma	(Genesis) 微型机车军事版 (E) [x]
g_mmm	(Genesis) 微型机车军事版 (欧版) (J-Cart)
g_sorcn	(Genesis) 巫师 (日版)
g_second	(Genesis) 武士魂 (欧版)
g_mushaa	(Genesis) 武者 (日版)
g_cyberp	(Genesis) 武装行警 (日版)
g_babyd	(Genesis) 小鬼当街 (美版) (Proto)
g_ecco2b	(Genesis) 小海豚 - 退潮后的游戏时间 (Beta)
g_ecco2u	(Genesis) 小海豚 - 退潮后的游戏时间 (美版)
g_ecco2	(Genesis) 小海豚 - 退潮后的游戏时间 (欧版)
g_ecco	(Genesis) 小海豚 (美版, 欧版)
g_eccoj	(Genesis) 小海豚 (日版)
g_ecco2j	(Genesis) 小海豚 II (日版)
g_eccojr	(Genesis) 小海豚2世 (美版, 澳洲版) (February 1995)
g_eccoj1	(Genesis) 小海豚2世 (美版, 澳洲版) (March 1995)
g_new3dg	(Genesis) 新3D高尔夫 (日版)
g_new3d2	(Genesis) 新3D高尔夫培柏海岸高尔夫球场 (日版)
g_new3d1	(Genesis) 新3D模拟高尔夫球 (日版)
g_new3d3	(Genesis) 新3D瓦乐奇迹高尔夫(日版)
g_solei1	(Genesis) 新创世纪 (France)
g_solei2	(Genesis) 新创世纪 (Germany)
g_solei4	(Genesis) 新创世纪 (Spain)
g_ragnac	(Genesis) 新创世纪 (韩国版)
g_soleil	(Genesis) 新创世纪 (欧版)
g_nobhao	(Genesis) 信长的野望 - 霸王传 (日版)
g_nobzen	(Genesis) 信长的野望 - 全国版 (日版)
g_nobamb	(Genesis) 信长的野望 (美版)
g_starcr	(Genesis) 星际巡洋舰 (日版)
g_sttnga	(Genesis) 星舰迷航记 - 星际移民 (美版)
g_sttng	(Genesis) 星舰迷航记 - 星际移民 (美版) (v1.1)
g_tazman	(Genesis) 旋风狗泰兹 (世界版)
g_elvin	(Genesis) 旋风女战士 (美版)
g_elvinj	(Genesis) 旋风女战士 (日版)
g_swdv	(Genesis) 血色之剑 (美版, 欧版)
g_alexk2	(Genesis) 亚历克斯 - 天空魔城 (韩国)
g_alexk1	(Genesis) 亚历克斯 - 天空魔城 (日版)
g_alexk4	(Genesis) 亚历克斯在魔城 (美版)
g_alexk3	(Genesis) 亚历克斯在魔城 (欧版)
g_alexkd	(Genesis) 亚历克斯在魔城 (欧版) (Rev A)
g_yswand	(Genesis) 伊苏国 III - 来自伊苏的冒险者 (日版)
g_ysiiiu	(Genesis) 伊苏国 III (美版)
g_evande	(Genesis) 伊万德的真实拳击 (世界版)
g_artali	(Genesis) 艺术生涯 (世界版)
g_alien1	(Genesis) 异形 3 (美版, 欧版)
g_alienu	(Genesis) 异形 3 (美版, 欧版) (Rev A)
g_alstm	(Genesis) 异形风暴 (世界版)
g_dinodi	(Genesis) 意大利足球 (欧版)
g_sonice	(Genesis) 音速方块 (日版) (SegaNet)
g_bubsy	(Genesis) 音速狐 (美版, 欧版)
g_bubsy2	(Genesis) 音速狐 II (美版, 欧版)
g_shin3u	(Genesis) 影武者 III - 大师之返 (美版)
g_shin3	(Genesis) 影武者 III - 大师之返 (欧版)
g_hard94	(Genesis) 硬派棒球 '94 (美版, 欧版)
g_hard95	(Genesis) 硬派棒球 '95 (美版)
g_hard3	(Genesis) 硬派棒球 III (美版)
g_eternu	(Genesis) 永恒之冠 (美版)
g_etern	(Genesis) 永恒之冠 (欧版)
g_eternb	(Genesis) 永恒之冠 (欧版) (Beta)
g_eternj	(Genesis) 永恒之冠 (日版, 韩国版)
g_batmfr	(Genesis) 永远的蝙蝠侠 (世界版)
g_arrow	(Genesis) 宇宙战机 (美版, 欧版)
g_arrowj	(Genesis) 宇宙战机 (日版)
g_genghi	(Genesis) 元朝秘史 II - 苍狼与白鹿 (美版)
g_elems	(Genesis) 元素支配者 (美版)
g_elemsj	(Genesis) 元素支配者 (日版)
g_arobo	(Genesis) 原子机械童 (美版)
g_aroboj	(Genesis) 原子机械童 (日版)
g_atomr1	(Genesis) 原子战士 (美版)
g_atomrn	(Genesis) 原子战士 (欧版)
g_maj	(Genesis) 约翰马顿橄榄球 - 美式足球 (日版)
g_ma	(Genesis) 约翰马顿橄榄球 (美版, 欧版)
g_ma93ce	(Genesis) 约翰马顿橄榄球 '93 - 冠军版 (美版)
g_madden	(Genesis) 约翰马顿橄榄球 '94 (美版, 欧版)
g_mad95	(Genesis) 约翰马顿橄榄球 '95 (美版, 欧版)
g_mad96	(Genesis) 约翰马顿橄榄球 '96 (美版, 欧版)
g_mad97	(Genesis) 约翰马顿橄榄球 '97 (美版, 欧版)
g_mad98	(Genesis) 约翰马顿橄榄球 '98 (美版)
g_joem2a	(Genesis) 约翰马顿橄榄球 II (世界版)
g_joem2	(Genesis) 约翰马顿橄榄球 II (世界版) (Rev A)
g_nflspo	(Genesis) 约翰马顿实况足球 '93 (美版, 欧版)
g_jrobo	(Genesis) 詹姆斯庞德 II - 代号无人机 (美版, 欧版)
g_jp2_realdump	(Genesis) 詹姆斯庞德 II - 代号无人机 (美版, 欧版) (proper dump)
g_jroboj	(Genesis) 詹姆斯庞德 II - 代号无人机 (日版, 韩国版)
g_clayu	(Genesis) 粘土战士 (美版)
g_clay	(Genesis) 粘土战士 (欧版)
g_zanyas	(Genesis) 斩 - 夜叉圆舞曲 (日版)
g_battle	(Genesis) 战斗高尔夫 (日版)
g_battmd	(Genesis) 战斗玛利亚 - 大吟釀 (日版, 韩国版)
g_btoads	(Genesis) 战斗蛙 (世界版)
g_btoadd	(Genesis) 战斗蛙与双截龙 (美版)
g_gaxea	(Genesis) 战斧 (世界版)
g_gaxe	(Genesis) 战斧 (世界版) (v1.1)
g_gaxe2	(Genesis) 战斧 II (世界版)
g_gaxe2b	(Genesis) 战斧 II (世界版) (Beta)
g_gaxe3	(Genesis) 战斧 III (日版)
g_mka	(Genesis) 真人快打 (世界版)
g_mk	(Genesis) 真人快打 (世界版) (v1.1)
g_mk3a	(Genesis) 真人快打 3 (美版)
g_mk3	(Genesis) 真人快打 3 (欧版)
g_mk2	(Genesis) 真人快打 II (世界版)
g_aaahh1	(Genesis) 真实妖怪 (美版)
g_aaahhr	(Genesis) 真实妖怪 (欧版)
g_pga96	(Genesis) 职业高尔夫球赛 96 (美版, 欧版)
g_pgaa	(Genesis) 职业高尔夫巡回赛 (美版, 欧版) (v1.1)
g_pga	(Genesis) 职业高尔夫巡回赛 (美版, 欧版) (v1.2)
g_pga2a	(Genesis) 职业高尔夫巡回赛 II (美版, 欧版)
g_pga2	(Genesis) 职业高尔夫巡回赛 II (美版, 欧版) (v1.1)
g_pga2b	(Genesis) 职业高尔夫巡回赛 II (日版)
g_atpto9	(Genesis) 职业网球巡回赛 (美版)
g_atptou	(Genesis) 职业网球巡回赛 (欧版)
g_nakaj2	(Genesis) 中岛悟 F1 超级驾照 (日版)
g_umk3a	(Genesis) 终级真人快打 3 (美版)
g_umk3	(Genesis) 终级真人快打 3 (欧版)
g_sensii	(Genesis) 足球经理 - 国际版 (欧版) (En,Fr,De,It)
g_premie	(Genesis) 足球经理 (欧版)
g_sensi	(Genesis) 足球经理 (欧版) (En,Fr,De,It)
g_prem97	(Genesis) 足球经理 97 (欧版)
gtmra	1000 英里大师赛车 (94/06/13)
gtmr	1000 英里大师赛车 (94/07/18)
gtmre	1000 英里大师赛车 (94/09/06)
gtmrusa	1000 英里大师赛车 (94/09/06)
gtmr2a	1000 英里大师赛车 2 (95/04/04)
gtmr2u	1000 英里大师赛车 2 (95/05/18)
gtmr2	1000 英里大师赛车 2 (95/05/24)
1941j	1941 - 反击战 (日版)
1941	1941 - 反击战 (世界版)
1942b	1942 - 空中大战 (初版)
1942w	1942 - 空中大战 (威廉斯电子)
1942a	1942 - 空中大战 (校正版 A)
1942abl	1942 - 空中大战 (校正版 A, 盗版)
1942	1942 - 空中大战 (校正版 B)
1943	1943 - 中途岛海战 (美版)
1943j	1943 - 中途岛海战 (日版)
1943kai	1943 改 - 中途岛海战 (日版)
1944d	1944 - 征服世界 (美版 000620 凤凰版) (盗版)
1944	1944 - 征服世界 (美版 000620)
1944j	1944 - 征服世界 (日版 000620)
1945kiii	1945k III
19xxb	19XX - 命运否决战 (巴西版 951218)
19xxd	19XX - 命运否决战 (美版 951207 凤凰版) (盗版)
19xx	19XX - 命运否决战 (美版 951207)
19xxjr1	19XX - 命运否决战 (日版 951207)
19xxj	19XX - 命运否决战 (日版 951225)
19xxh	19XX - 命运否决战 (西班牙版 951218)
19xxa	19XX - 命运否决战 (亚洲版 951207)
2020bb	2020 年超级棒球 (第1套)
2020bba	2020 年超级棒球 (第2套)
2020bbh	2020 年超级棒球 (第3套)
4play	4 player 输入测试
7ordi	7 张牌 (韩国版)
eightman	8 号超人
cps1demo	Chaos 演示 (CPS-1)
neodemo	Chaos 演示 (Homebrew)
sfzch	CPS Changer - 少年街霸 (日版 951020)
wofch	CPS Changer - 吞食天地 II - 赤壁之战 (日版 921031)
tokiu	JUJU 传说 (美版)
juju	JUJU 传说 (日版)
jujub	JUJU 传说 (日版, 盗版)
toki	JUJU 传说 (世界版 第1套)
tokia	JUJU 传说 (世界版 第2套)
multchmpk	Multi 冠军 (韩国版)
multchmp	Multi 冠军 (世界版)
mchampdx	Multi 冠军豪华版 (版本. 0106, 06/01/2000)
mchampdxa	Multi 冠军豪华版 (版本. 1126, 26/11/1999)
neo2500	Neo 2500 演示 (Homebrew)
neomrdo	Neo 嘟先生
syscheck	Neo 系统测试 (ver 1.0b, Homebrew)
neodrift	Neo 越野赛车
neonopon	Neo 智力方块 (Beta, Homebrew)
neogeo	Neo-Geo
neogeo	Neo-Geo
neocup98	Neogeo 杯 '98  - 胜利之路
pgemeni	P-GeMeni (060123)
pgm	PGM (Polygame Master) System BIOS
pgmdemo	PGM 演示 (Homebrew)
parodiusj	Q版沙罗曼蛇 (日版)
parodius	Q版沙罗曼蛇 (世界版)
radicav1	Radica: Volume 1 (索尼克, 兽王记, 战斧, 魔法气泡外传, 变色龙, 小鸟菲基) (美版)
radicasf	Radica: 街头霸王合集 (街头霸王 2 特别冠军加强版, 大魔界村) (欧版)
rbff1	RB 饿狼传说
rbff1a	RB 饿狼传说 (问题修复版)
rbff2	RB 饿狼传说 2 - 新的来者 (第1套)
rbff2h	RB 饿狼传说 2 - 新的来者 (第2套)
rbff2k	RB 饿狼传说 2 - 新的来者 (韩国版)
rbffspec	RB 饿狼传说 特别版
spyu	S.P.Y. - 特别计划 Y (美版 ver. M)
spy	S.P.Y. - 特别计划 Y (世界版 ver. N)
srdmissn	S.R.D. 任务
defense	SDI - 守护者 (系统 16B, FD1089A 317-0028)
sdibl	SDI - 战略防卫构想 (盗版)
sdi	SDI - 战略防卫构想 (日版, 旧, 系统 16A, FD1089B 317-0027)
sdib	SDI - 战略防卫构想 (系统 16B, FD1089A 317-0028)
sdfight	SD斗士 (韩国版)
ssmissin	SS 任务 - 特命编
swatpolc	SWAT 特警组
ttmahjng	T.T 麻将
tws96	Tecmo 世界杯足球 '96
earthjkr	U.N. 国防战机: 地球战役
vfive	V-5 战机 (日版)
wwfsstaru	WWF 超级巨星 (美版)
wwfsstara	WWF 超级巨星 (美版, 新版)
wwfsstar	WWF 超级巨星 (欧版)
wwfsstarj	WWF 超级巨星 (日版)
wwfwfesta	WWF 狂热摔跤 (美版 Tecmo)
wwfwfestb	WWF 狂热摔跤 (美版 盗版)
wwfwfest	WWF 狂热摔跤 (美版 第1套)
wwfwfestj	WWF 狂热摔跤 (日版)
xmen2pa	X - 战警 (2 Players ver AAA)
xmen2pe	X - 战警 (2 Players ver EAA)
xmen2pj	X - 战警 (2 Players ver JAA)
xmene	X - 战警 (4 Players ver EBA)
xmenj	X - 战警 (4 Players ver JBA)
xmen	X - 战警 (4 Players ver UBB)
xmen6p	X - 战警 (6 Players ver ECB)
xmen6pu	X - 战警 (6 Players ver UCB)
xmvsfb	X - 战警 对 街头霸王 (巴西版 961023)
xmvsfu1d	X - 战警 对 街头霸王 (美版 961004 凤凰版) (盗版)
xmvsfur1	X - 战警 对 街头霸王 (美版 961004)
xmvsfu	X - 战警 对 街头霸王 (美版 961023)
xmvsfr1	X - 战警 对 街头霸王 (欧洲版 960910)
xmvsf	X - 战警 对 街头霸王 (欧洲版 961004)
xmvsfjr2	X - 战警 对 街头霸王 (日版 960909)
xmvsfjr1	X - 战警 对 街头霸王 (日版 960910)
xmvsfj	X - 战警 对 街头霸王 (日版 961004)
xmvsfh	X - 战警 对 街头霸王 (西班牙版 961004)
xmvsfar1	X - 战警 对 街头霸王 (亚洲版 960919)
xmvsfa	X - 战警 对 街头霸王 (亚洲版 961023)
xmcotau	X - 战警: 磁场原子人 (美版 950105)
xmcotad	X - 战警: 磁场原子人 (欧洲版 950105 凤凰版) (盗版)
xmcota	X - 战警: 磁场原子人 (欧洲版 950105)
xmcotajr	X - 战警: 磁场原子人 (日版 941208 租借版)
xmcotaj2	X - 战警: 磁场原子人 (日版 941219)
xmcotaj1	X - 战警: 磁场原子人 (日版 941222)
xmcotaj	X - 战警: 磁场原子人 (日版 950105)
xmcotah	X - 战警: 磁场原子人 (西班牙版 950331)
xmcotaa	X - 战警: 磁场原子人 (亚洲版 941217)
sectionz	Z 地带 (第1套)
sectionza	Z 地带 (第2套)
zedblade	Z 字军刀 / 末日之战
rygar	阿尔卑斯古战士 (美版 第1套)
rygar2	阿尔卑斯古战士 (美版 第2套)
rygar3	阿尔卑斯古战士 (美版 第3套 旧版)
rygarj	阿尔卑斯古战士 (日版)
agress	阿古雷司 - 导弹大战略
agressb	阿古雷司 - 导弹大战略 (英文 盗版)
bongo	阿古历险记
arabian	阿拉丁
arabiana	阿拉丁 (Atari)
alibaba	阿里巴巴与四十大盗
ambush	阿米巴契战机
ambusht	阿米巴契战机 (Tecfri)
ambushv	阿米巴契战机 (Volt Elec co-ltd)
gatedoom1	暗黑封印 - 毁灭之门 (美版 校正版 1)
gatedoom	暗黑封印 - 毁灭之门 (美版 校正版 4)
darksealj	暗黑封印 - 毁灭之门 (日版)
darkseal1	暗黑封印 - 毁灭之门 (世界版 校正版 1)
darkseal	暗黑封印 - 毁灭之门 (世界版 校正版 3)
blktiger	暗黑之虎
blkdrgon	暗黑之龙
blktigerb1	暗黑之龙 (盗版 第1套)
bktigrb2	暗黑之龙 (盗版 第2套)
blkdrgonb	暗黑之龙 (盗版)
blkheart	暗黑之心
blkheartj	暗黑之心 (日版)
killbld	傲剑狂刀 (ver. 104)
killbldt	傲剑狂刀 (ver. 109, 中文基板)
brix	芭莉斯公丝
samsho4k	霸王传说 (韩国审查版 侍魂 IV)
ninjamas	霸王忍法帖
bestbest	霸中霸
berlwall	柏林墙
berlwallt	柏林墙 (盗版 ?)
semibase	棒球 (SemiCom Baseball) (韩国版)
mvpj	棒球 MVP (第1套, 日版, FD1094 317-0142)
mvp	棒球 MVP (第2套, 美版, FD1094 317-0143)
dokaben	棒球大饭桶 (日版)
mjleague	棒球联盟
bstars	棒球之星 (第1套)
bstarsh	棒球之星 (第2套)
bstars2	棒球之星 2
columnsn	宝石方块 (Neo Geo)
rollerg	暴力溜冰 (美版)
rollergj	暴力溜冰 (日版)
breakers	爆裂人
breakrev	爆烈人 复仇 / 末日英雄 加强版
bakubrkr	爆裂战机
explbrkr	爆裂战机 Explosive
riotcity	暴乱之城 (日版)
aliensec	爆突 (第1套)
baraduke	爆突 (第2套)
lbowling	爆笑保龄球
avengers	必杀无赖拳 (美版 第1套)
avengers2	必杀无赖拳 (美版 第2套)
buraiken	必杀无赖拳 (日版)
batridj	蝙蝠骑警 - 装甲军团 - B 版本 (日版) (Fri Feb 13 1998)
batridk	蝙蝠骑警 - 装甲军团 (韩国版) (Fri Feb 13 1998)
batridu	蝙蝠骑警 - 装甲军团 (美版) (Fri Feb 13 1998)
batrid	蝙蝠骑警 - 装甲军团 (欧洲版) (Fri Feb 13 1998)
batridja	蝙蝠骑警 - 装甲军团 (日版) (Mon Dec 22 1997)
batridc	蝙蝠骑警 - 装甲军团 (中国版) (Fri Feb 13 1998)
shadfrce	变身忍者 (美版 版本 2)
shadfrcejv2	变身忍者 (日版 版本 2)
shadfrcej	变身忍者 (日版 版本 3)
crospang	表情气泡
msbingo	宾果小姐拼图方块
minefld	布雷区
jumping	彩虹岛
rainbowe	彩虹岛 (额外版)
rainbowo	彩虹岛 (旧版)
rainbow	彩虹岛 (新版)
gnbarich	彩京砖块物语
nost	超电磁炮
nostk	超电磁炮 (韩国版)
nostj	超电磁炮 (日版)
exedexes	超浮游要塞
savgbees	超浮游要塞 - 致命大黄蜂
sucasino	超级赌城
sdodgeb	超级躲避球 / 热血斗球传说
scontra	超级魂斗罗
scontraj	超级魂斗罗 (日版)
sfx	超级火箭
spf2xjd	超级街霸方块 II X (日版 960531 凤凰版) (盗版)
spf2xj	超级街霸方块 II X (日版 960531)
spf2t	超级街霸方块 II 加速版 (美版 960620)
spf2th	超级街霸方块 II 加速版 (西班牙版 960531)
spf2ta	超级街霸方块 II 加速版　(亚洲版 960529)
ssf2ud	超级街头霸王 II - 新的来者 (美版 930911 凤凰版) (盗版)
ssf2u	超级街头霸王 II - 新的来者 (美版 930911)
ssf2jr2	超级街头霸王 II - 新的来者 (日版 930910)
ssf2jr1	超级街头霸王 II - 新的来者 (日版 930911)
ssf2j	超级街头霸王 II - 新的来者 (日版 931005)
ssf2	超级街头霸王 II - 新的来者 (世界版 930911)
ssf2h	超级街头霸王 II - 新的来者 (西班牙版 930911)
ssf2ar1	超级街头霸王 II - 新的来者 (亚洲版 930914)
ssf2a	超级街头霸王 II - 新的来者 (亚洲版 931005)
ssf2tbj	超级街头霸王 II - 战斗联赛 (日版 930910)
ssf2tbr1	超级街头霸王 II - 战斗联赛 (世界版 930911)
ssf2tbd	超级街头霸王 II - 战斗联赛 (世界版 931119 凤凰版) (盗版)
ssf2tb	超级街头霸王 II - 战斗联赛 (世界版 931119)
ssf2xjd	超级街头霸王 II X 向最强挑战 (日版 940223 凤凰版) (盗版)
ssf2xj	超级街头霸王 II X 向最强挑战 (日版 940223)
ssf2tur1	超级街头霸王 II 加速版 (美版 940223)
ssf2tu	超级街头霸王 II 加速版 (美版 940323)
ssf2t	超级街头霸王 II 加速版 (世界版 940223)
ssf2ta	超级街头霸王 II 加速版 (亚洲版 940223)
upndown	超级金龟车 (315-5030)
upndownu	超级金龟车 (未加密)
turbofrc	超级空军
sgemfd	超级口袋战士 (美版 970904 凤凰版) (盗版)
sgemf	超级口袋战士 (美版 970904)
pfghtj	超级口袋战士 (日版 970904)
sgemfh	超级口袋战士 (西班牙版 970904)
sgemfa	超级口袋战士 (亚洲版 970904)
marukin	超级麻将禁版 (日版 901017)
mshb	超级漫画英雄 (巴西版 951117)
mshud	超级漫画英雄 (美版 951024 凤凰版) (盗版)
mshu	超级漫画英雄 (美版 951024)
msh	超级漫画英雄 (欧洲版 951024)
mshjr1	超级漫画英雄 (日版 951024)
mshj	超级漫画英雄 (日版 951117)
mshh	超级漫画英雄 (西班牙版 951117)
msha	超级漫画英雄 (亚洲版 951024)
mshvsfb1	超级漫画英雄 对 街头霸王 (巴西版 970625)
mshvsfb	超级漫画英雄 对 街头霸王 (巴西版 970827)
mshvsfu1	超级漫画英雄 对 街头霸王 (美版 970625)
mshvsfu	超级漫画英雄 对 街头霸王 (美版 970827)
mshvsf	超级漫画英雄 对 街头霸王 (欧洲版 970625)
mshvsfj2	超级漫画英雄 对 街头霸王 (日版 970625)
mshvsfj1	超级漫画英雄 对 街头霸王 (日版 970702)
mshvsfj	超级漫画英雄 对 街头霸王 (日版 970707)
mshvsfh	超级漫画英雄 对 街头霸王 (西班牙版 970625)
mshvsfa1	超级漫画英雄 对 街头霸王 (亚洲版 970620)
mshvsfa	超级漫画英雄 对 街头霸王 (亚洲版 970625)
sbbros	超级魔鬼气泡 (美版 901001)
spangj	超级魔鬼气泡 (日版 901023)
spang	超级魔鬼气泡 (世界版 900914)
sboblboa	超级魔幻气泡 (第1套)
sboblbob	超级魔幻气泡 (第2套)
smgpja	超级摩纳哥GP赛车 (第1套, 日版, Rev A, FD1094 317-0124a)
smgpj	超级摩纳哥GP赛车 (第2套, 日版, Rev B, FD1094 317-0124a)
smgpu3	超级摩纳哥GP赛车 (第3套, 美版, FD1094 317-0125a)
smgpu2	超级摩纳哥GP赛车 (第4套, 美版, Rev A, FD1094 317-0125a)
smgpu1	超级摩纳哥GP赛车 (第5套, 美版, Rev B, FD1094 317-0125a)
smgpu	超级摩纳哥GP赛车 (第6套, 美版, Rev C, FD1094 317-0125a)
smgp5	超级摩纳哥GP赛车 (第7套, 世界版, 'Air Drive Cabinet', FD1094 317-0126)
smgp6	超级摩纳哥GP赛车 (第8套, 世界版, Rev A, FD1094 317-0126a)
smgp	超级摩纳哥GP赛车 (第9套, 世界版, Rev B, 'Twin', FD1094 317-0126a)
shangonle	超级摩托车
shangon3	超级摩托车 (sitdown/直立型, FD1089B 317-0034)
shangon	超级摩托车 (sitdown/直立型, 未保护版)
shangon2	超级摩托车 (迷你车, Rev A, FD1089B 317-0034)
superbon	超级庞德 (Scobra 硬件)
shinobls	超级忍 (Star 盗版, 系统 16A)
shinobi1	超级忍 (第1套, 系统 16A, FD1094 317-0050)
shinobi2	超级忍 (第2套, 系统 16B, FD1094 317-0049)
shinobi3	超级忍 (第3套, 系统 16B, MC-8123B 317-0054)
shinobi4	超级忍 (第4套, 系统 16B, MC-8123B 317-0054)
shinobi5	超级忍 (第5套, 系统 16B, 未保护版)
shinobi	超级忍 (第6套, 系统 16A, 未保护版)
suprtrio	超级三重奏
suprglob	超级水滴
theglobp	超级水滴
sprglobp	超级水滴 (Pac-Man 硬件)
sprglbpg	超级水滴 (Pac-Man 硬件) 德国版
theglob3	超级水滴 (第3套)
beastf	超级水滴 Beastie Feastie
superg	超级小蜜蜂 (galaxiana hack)
scobra	超级眼镜蛇
scobrase	超级眼镜蛇 (Sega)
scobras	超级眼镜蛇 (Stern)
scobrab	超级眼镜蛇 (盗版)
suprheli	超级眼镜蛇 (加强版眼镜蛇 盗版)
majest12	超级宇宙侵略者 '90 (日版)
ssi	超级宇宙侵略者 '91 (世界版)
searchey	超级找一找 - 搜寻之眼
searchp2	超级找一找 - 搜寻之眼 加强版 V2.0
suprleag	超级职棒联盟 (FD1094 317-0045)
swat	超能战警 (315-5048)
mpangu	超强! 魔鬼气泡 (美版 001010)
mpangr1	超强! 魔鬼气泡 (欧洲版 000925)
mpang	超强! 魔鬼气泡 (欧洲版 001010)
mpangj	超强! 魔鬼气泡 (日版 001011)
enforce	超强火力 (日版)
superman	超人
supermanj	超人 (日版)
gowcaizr	超人学园钢帝王
macross	超时空要塞
macross2	超时空要塞 II
legiono	超时迷宫 (版本 1.05)
legion	超时迷宫 (版本 2.03)
ironclad	超铁战机 (Wii Virtual Console to MVS Conversion)
gprider1	超真实 GP 摩托车 (第1套, 美版, FD1094 317-0162)
gprider	超真实 GP 摩托车 (第2套, 世界版, FD1094 317-0163)
solfigtr	沉默战士 (世界版)
punisheru	惩罚者 (美版 930422)
punisherj	惩罚者 (日版 930422)
punisher	惩罚者 (世界版 930422)
vigilantu	成龙踢馆 - 功夫小子 (美版)
vigilantj	成龙踢馆 - 功夫小子 (日版)
vigilant	成龙踢馆 - 功夫小子 (世界版)
mspacman	吃豆人
mspacmab	吃豆人 (盗版)
mspacmbe	吃豆人 (盗版, 加密)
mspacmnf	吃豆人 (加速修改版)
mspacmat	吃豆人 Attack
pacgal	吃豆人 Pac-Gal
mspacpls	吃豆人 Plus
mschamp	吃豆人 冠军版
pacplus	吃豆人Plus
warzard	赤色大地 (日版, 961121)
vanvan	冲冲车
vanvank	冲冲车 (Karateco)
vanvanb	冲冲车 (第3套)
rallybik	冲刺野郎
aburner	冲破火网 (日版)
aburner2	冲破火网 II
crshrace	冲撞赛车 - 离合器 (第1套)
crshrace2	冲撞赛车 - 离合器 (第2套)
zzyzzyxx	虫虫救美 (第1套)
zzyzzyxx2	虫虫救美 (第2套)
pnyaa	宠物方块
pnyaand	宠物方块 (C 解密)
liquidku	丑八怪大冒险 (美版)
mizubaku	丑八怪大冒险 (日版)
liquidk	丑八怪大冒险 (世界版)
blswhstl	出击兵蜂 (版本 L)
detatwin	出击兵蜂 (日版 ver. J)
strider	出击飞龙 (美版 第1套)
striderua	出击飞龙 (美版 第2套)
striderjr	出击飞龙 (日版 Resale Ver.)
striderj	出击飞龙 (日版)
ddcrew1	除暴部队 (第1套, 世界版, 4 Player, FD1094 317-0187)
ddcrew2	除暴部队 (第2套, 世界版, 2 Player, FD1094 317-0184)
ddcrewu	除暴部队 (第3套, 美版, 4 Player, FD1094 317-0186)
ddcrew	除暴部队 (第4套, 世界版, 3 Player, FD1094 317-0190)
ddcrewj	除暴部队 (第5套, 日版, 2 Player, FD1094 317-0182)
legend	传奇
cawingu	雌虎战机 (美版 901012)
cawingj	雌虎战机 (日版 901012)
cawingr1	雌虎战机 (世界版 901009)
cawing	雌虎战机 (世界版 901012)
exctleag	刺激大联盟 (FD1094 317-0079)
truxton	达人
truxton2	达人王 II
mole	打地鼠
mogura	打地鼠 - 柯拿米 (日版)
s1945k	打击者 1945 (韩国版)
s1945a	打击者 1945 (日版 / 世界版)
s1945j	打击者 1945 (日版)
s1945jn	打击者 1945 (日版, 未保护版)
s1945	打击者 1945 (世界版)
s1945ii	打击者 1945 II
s1945iii	打击者 1945 III (世界版) / Strikers 1999 (日版)
s1945p	打击者 1945 加强版
s1945pn	打击者 1945 加强版 (C 解密)
bestri	打星星 (韩国版)
wallc	打砖 (第1套)
wallca	打砖 (第2套)
arknoid2u	打砖块 - DOH 复仇 (美版)
arknoid2j	打砖块 - DOH 复仇 (日版)
arknoid2	打砖块 - DOH 复仇 (世界版)
arkangc	打砖块 (Game Corporation 盗版, 第1套)
arkblock	打砖块 (Game Corporation 盗版, 第1套)
arkangc2	打砖块 (Game Corporation 盗版, 第2套)
arkbloc2	打砖块 (Game Corporation 盗版, 第2套)
arkatayt	打砖块 (Tayto 盗版)
arktayt2	打砖块 (Tayto 盗版, harder)
arkgcbl	打砖块 (盗版 on Block hardware, 第1套)
arkgcbla	打砖块 (盗版 on Block hardware, 第2套)
arkmcubl	打砖块 (盗版 with MCU)
ark1ball	打砖块 (盗版 with MCU, harder)
arkanoidu	打砖块 (美版)
arkatour	打砖块 (美版)
arkanoiduo	打砖块 (美版, older)
arkanoidj	打砖块 (日版)
arkanoid	打砖块 (世界版)
paddle2	打砖块 2 (盗版 on Block hardware)
blockgal	打砖块美女版 (MC-8123B, 317-0029)
bigbucks	大巴克
bigbang	大轰动 (9th Nov. 1993)
raf102j	大家来找碴 (ver. 102, 日文基版)
photoy2k	大家来找碴 (ver. 104)
bloodwar	大江户格斗 - 血忍
ckongg	大金刚 (盗版 Galaxian 硬件)
ckongmc	大金刚 (盗版 Moon Cresta 硬件)
ckongs	大金刚 (紧急起飞 硬件)
ckong	大金刚 II (第1套)
dkongjrm	大金刚 Jr. (盗版 Moon Cresta 硬件)
dkongjr	大金刚 Junior (美版)
dunkshot	大扣篮 (FD1089A 317-0022)
turfmast	大联盟高尔夫
gallag	大蜜蜂
galagamf	大蜜蜂 (Midway 第1套 快速射击修改版)
galagamw	大蜜蜂 (Midway 第1套)
galagamk	大蜜蜂 (Midway 第2套)
galaga	大蜜蜂 (Namco rev. B)
galagao	大蜜蜂 (Namco)
ghoulsu	大魔界村 (美版)
daimakair	大魔界村 (日版 Resale Ver.)
daimakai	大魔界村 (日版)
ghouls	大魔界村 (世界版)
imsorry	大头课长捡金块 (315-5110, 美版)
imsorryj	大头课长捡金块 (315-5110, 日版)
twinhawku	大旋风 (美版)
daisenpu	大旋风 (日版)
twinhawk	大旋风 (世界版)
eyes	大眼精灵 (工艺之星)
eyes2	大眼精灵 (洛克奥拉)
eyeszac	大眼精灵 (萨卡利亚)
stratgyx	大战略 X
strongx	大战略 X
stratgys	大战略 X (Stern)
kangaroo	袋鼠
kangarooa	袋鼠 (Atari)
kangaroob	袋鼠 (盗版)
feversos	弹铳 (国际版, Ver. 98/09/25)
dfeveron	弹铳 (日版, Ver. 98/09/17)
route16b	道路 16 (盗版)
route16	道路 16 (第1套)
route16a	道路 16 (第2套)
routex	道路 16 Route X (盗版)
ledstorm	道路风暴 (美版)
ledstorm2	道路风暴 2011 (美版)
losttombh	盗募者 (困难版)
losttomb	盗募者 (容易版)
ssideki	得点王 - 超级队友
ssideki2	得点王 2 - 世界锦标赛
ssideki3	得点王 3 - 光荣的挑战
ssideki4	得点王 4 - 终极十一人
viewpoin	得分王 / 视点
toryumon	登龙门
mshuttle	登月火箭 (美版?)
mshuttlej2	登月火箭 (日版 第2套)
mshuttlej	登月火箭 (日版)
dcon	地球防卫军
terraf	地球自卫队 (第1套)
terrafa	地球自卫队 (第2套)
terrafu	地球自卫队 (美版)
catacomb	地下墓穴
hellfire1	地狱火 (1P Ver.)
hellfire3	地狱火 (1P Ver., alt)
hellfire	地狱火 (2P Ver.)
hellfire2	地狱火 (2P Ver., first edition)
bonzeadvu	地狱小和尚 (美版)
jigkmgri	地狱小和尚 (日版)
bonzeadvo	地狱小和尚 (世界版, 旧版)
bonzeadv	地狱小和尚 (世界版, 新版)
grdians	电神魔傀 II
hustler	电视撞球
billiard	电视撞球 (Video Hustler 盗版)
hustlerb	电视撞球 (盗版)
vpool	电视撞球台 (盗版 Moon Cresta 硬件)
slapfgtr	电子作战 (盗版)
slapfigh	电子作战 (第1套)
slapbtjp	电子作战 (日版 盗版)
slapbtuk	电子作战 (英国版 盗版)
superspy	谍报飞龙
tpgolf	顶尖高尔夫
tophuntr	顶尖猎人 - 罗迪 & 凯茜 (第1套)
tophuntrh	顶尖猎人 - 罗迪 & 凯茜 (第2套)
pdriftj	动力甩尾 (日版)
pdrifta	动力甩尾 (世界版)
pdrift	动力甩尾 (世界版, Rev A)
pdrifte	动力甩尾 (世界版, 早期版)
hachamf	动物也疯狂 (19th Sep. 1991)
bullfgt	斗牛 (315-5065)
thetogyu	斗牛 (315-5065, 日版)
karatblzu	斗神光辉 (美版)
karatblzj	斗神光辉 (日版)
karatblz	斗神光辉 (世界版)
karnovr	斗士的历史 - 卡洛夫的复仇
trojanr	斗者挽歌 - 特洛伊 (Romstar)
trojan	斗者挽歌 - 特洛伊 (美版)
trojanj	斗者挽歌 - 特洛伊 (日版)
mrdo	嘟先生!
mrdofix	嘟先生! (bugfixed)
mrdot	嘟先生! (Taito)
mrdoy	嘟先生! (工程版)
mrdu	嘟先生! Mr. Du!
mrlo	嘟先生! Mr. Lo!
yankeedo	嘟先生! Yankee DO!
vliner	赌博机 (第1套)
vlinero	赌博机 (第2套)
jockeygp	赌马
jckygpnd	赌马 (C 解密)
flipshot	盾牌大战
dotrikun2	多托君 (旧版)
dotrikun	多托君 (新版)
daraku	堕落天使
blockhl	俄罗斯方块 - 黑洞
quarth	俄罗斯方块 - 黑洞 (日版)
tetrsark	俄罗斯方块 (D.R. 韩国版)
tetrisbl	俄罗斯方块 (盗版)
tetris1	俄罗斯方块 (第1套, 日版, 系统 16B, FD1094 317-0091)
tetris2	俄罗斯方块 (第2套, 日版, 系统 16B, FD1094 317-0092)
tetris3	俄罗斯方块 (第3套, 日版, 系统 16A, FD1094 317-0093a)
tetris	俄罗斯方块 (第4套, 日版, 系统 16A, FD1094 317-0093)
tgm2	俄罗斯方块大师 2
tgm2p	俄罗斯方块大师 2 Plus
atomicp	俄罗斯方块解谜 Philko (韩国版)
finalttr	俄罗斯方块终结者 - 对战篇
garoun	饿狼 - 群狼之证 / 狼之烙印 (C 解密)
garoubl	饿狼 - 群狼之证 / 狼之烙印 (盗版)
garou	饿狼 - 群狼之证 / 狼之烙印 (第1套)
garouo	饿狼 - 群狼之证 / 狼之烙印 (第2套)
garoup	饿狼 - 群狼之证 / 狼之烙印 (工程版)
fatfury1	饿狼传说 - 宿命之战
fatfury2	饿狼传说 2 - 新的战斗
fatfury3	饿狼传说 3 - 远古征战
fatfursp	饿狼传说 特别版 (第1套)
fatfursa	饿狼传说 特别版 (第2套)
devstors3	饿流祸 (ver. V)
devstors2	饿流祸 (ver. X)
devstors	饿流祸 (ver. Z)
garuka	饿流祸 (日版 ver. W)
hcastleo	恶魔城 (版本 K)
hcastle	恶魔城 (版本 M)
hcastljo	恶魔城 (日版 版本 N)
hcastlej	恶魔城 (日版 版本 P)
vsavu	恶魔救世主 - 吸血鬼贵族 (美版 970519)
vsavd	恶魔救世主 - 吸血鬼贵族 (欧洲版 970519 凤凰版) (盗版)
vsav	恶魔救世主 - 吸血鬼贵族 (欧洲版 970519)
vsavj	恶魔救世主 - 吸血鬼贵族 (日版 970519)
vsavh	恶魔救世主 - 吸血鬼贵族 (西班牙版 970519)
vsava	恶魔救世主 - 吸血鬼贵族 (亚洲版 970519)
vsav2	恶魔救世主 2 - 吸血鬼贵族 (日版 970913)
nwarrb	恶魔猎人 - 恶魔的复仇 (巴西版 950403)
nwarrud	恶魔猎人 - 恶魔的复仇 (美版 950406 凤凰版) (盗版)
nwarru	恶魔猎人 - 恶魔的复仇 (美版 950406)
nwarr	恶魔猎人 - 恶魔的复仇 (欧洲版 950316)
nwarrh	恶魔猎人 - 恶魔的复仇 (西班牙版 950403)
nwarra	恶魔猎人 - 恶魔的复仇 (亚洲版 950302)
vhunt2r1	恶魔猎人 2 - 恶魔的复仇 (日版 970913)
vhunt2	恶魔猎人 2 - 恶魔的复仇 (日版 970929)
dstlku1d	恶魔战士 - 午夜斗士 (美版 940705 凤凰版) (盗版)
dstlkur1	恶魔战士 - 午夜斗士 (美版 940705)
dstlku	恶魔战士 - 午夜斗士 (美版 940818)
dstlk	恶魔战士 - 午夜斗士 (欧洲版 940705)
vampjr1	恶魔战士 - 午夜斗士 (日版 940630)
vampja	恶魔战士 - 午夜斗士 (日版 940705 alt)
vampj	恶魔战士 - 午夜斗士 (日版 940705)
dstlkh	恶魔战士 - 午夜斗士 (西班牙版 940818)
dstlka	恶魔战士 - 午夜斗士 (亚洲版 940705)
ctomaday	蕃茄超人
contcircu	方程式赛车 - F1 巡回赛 (美版 第1套)
contcircua	方程式赛车 - F1 巡回赛 (美版 第2套)
contcirc	方程式赛车 - F1 巡回赛 (世界版)
drivfrcp	方程式赛车 Force (Pac-Man 转换)
drivfrcb	方程式赛车 Force (小蜜蜂 转换 盗版)
drivfrcg	方程式赛车 Force (小蜜蜂 转换)
azurian	防卫射击
warofbug	飞虫大作战
markham	飞碟入侵
orbitron	飞碟巡航
wschampa	飞行射击冠军 V1.01
wschamp	飞行射击冠军 V2.0
airwolf	飞狼
skywolf	飞狼 (第1套)
skywolf2	飞狼 (第2套)
skywolf3	飞狼 (第3套)
airwolfa	飞狼 (美版)
dragnblz	飞龙骑士
asukaj	飞鸟 & 飞鸟 (日版)
asuka	飞鸟 & 飞鸟 (世界版)
grindstm	飞鹰风暴
grindstma	飞鹰风暴 (旧版)
hexion	蜂巢俄罗斯方块 (日版)
backfirt	烽火佳人 (Tecmo, 盗版)
fnkyfish	疯狂的鱼
fbfrenzy	疯狂橄榄球
madgear	疯狂机车 (美版)
madgearj	疯狂机车 (日版)
gbusters	疯狂警察 (第1套)
gbustersa	疯狂警察 (第2套)
crazycop	疯狂警察 (日版)
funkybee	疯狂蜜蜂
funkybeeb	疯狂蜜蜂 (盗版, harder)
cclimbr2	疯狂爬梯者 2 (日版)
cclimbr2a	疯狂爬梯者 2 (日版, 难度加强版)
batsugun	疯狂枪支 (第1套)
batsuguna	疯狂枪支 (第2套)
batsugunsp	疯狂枪支 (特别版)
tazzmang	疯狂塔斯 (Galaxian 硬件)
tazmania	疯狂塔斯 (第1套)
tazmani2	疯狂塔斯 (第2套)
hyperpac	疯狂小精灵
hyperpacb	疯狂小精灵 (盗版)
hypsptsp	疯狂运动会特别版 (日版)
ridhero	风速英雄 (第1套)
ridheroh	风速英雄 (第2套)
savagere	风云默示录 - 格斗创世
kizuna	风云默示录 2 - 超级组队战
acrobatm	风云战机
phoenxp2	凤凰角色 2
sonofphx	凤凰之子
repulse	凤凰之子 - 星际联邦
99lstwar	凤凰之子 / '99 最后战争
99lstwark	凤凰之子 / '99 最后战争 (Kyugo)
99lstwara	凤凰之子 / '99 最后战争 (替换版)
scregg	孵蛋大战
eggs	孵蛋大战 Eggs
mrflea	弗列克惊异大冒险
revenger	复仇者
oscaru	钢铁金刚 (美版)
oscarj1	钢铁金刚 (日版 校正版 1)
oscarj2	钢铁金刚 (日版 校正版 2)
oscar	钢铁金刚 (世界版 校正版 0)
strahl	钢铁要塞 (日版 第1套)
strahla	钢铁要塞 (日版 第2套)
levers	杠杆翘板
galmedes	高米达斯星战 (日版)
srumbler	高速追击令 (第1套)
srumbler2	高速追击令 (第2套)
rushcrsh	高速追击令 (日版)
twinadvk	哥俩好大冒险 (韩国版)
twinadv	哥俩好大冒险 (世界版)
kog	格斗之王 (盗版)
shootbul	公牛飞镖
plumppop	狗狗乐园 (日版)
dremshpr	购物梦语
eto	古今东西干支物语 (日版)
nob	怪叔叔救美 (日版)
nobb	怪叔叔救美 (日版,盗版)
dduxbl	怪鸭冒险记 (盗版)
ddux1	怪鸭冒险记 (第1套, 8751 317-0095)
ddux	怪鸭冒险记 (第2套, FD1094 317-0096)
cltchitrj	关键打者 (第1套, 日版, FD1094 317-0175)
cltchitr	关键打者 (第2套, 美版, FD1094 317-0176)
hthero	冠军杯足球赛 (日版)
euroch92	冠军杯足球赛 (世界版)
footchmp	冠军杯足球赛 (世界版)
aurailj	光环 (第1套, 日版, FD1089A 317-0167)
aurail1	光环 (第2套, 世界版, FD1089B 317-0168)
aurail	光环 (第3套, 美版, 未保护版)
spec2k	光普 2000
lghostu	鬼魂射击 (第1套, 美版, 317-0165)
lghost	鬼魂射击 (第2套, 世界版, 317-0166)
zintrkcd	诡计 / 挑战史来姆 (CD to MVS Conversion, Hack)
zintrckb	诡计 / 挑战史来姆 (修改版 / 盗版)
ghostlop	鬼精灵投球手 (工程版)
mrkougar	鬼灵精先生
mrkougb	鬼灵精先生 (盗版 第1套)
mrkougb2	鬼灵精先生 (盗版 第2套)
mrkougar2	鬼灵精先生 (早期版)
kingball	国王与气球 (美版)
kingballj	国王与气球 (日版)
buccanrs	海盗 (第1套)
buccanrsa	海盗 (第2套)
pirates	海盗 [经典枪战]
higemaru	海盗船水手
800fath	海底潜航 - 800 海里
mariner	海底潜航 - 水手
aquarium	海底生物战 (日版)
porter	海男 (盗版 Moon Cresta 硬件)
bayroute1	海湾战争 (第1套, 美版, 未保护版)
bayroutej	海湾战争 (第2套, 日版, FD1094 317-0115)
bayroute	海湾战争 (第3套, 世界版, FD1094 317-0116)
garogun	韩语问答 (韩国版)
strkfgtr	捍卫铁鹰 (日版)
lastduelb	行星战争 2012 (盗版)
lastduelo	行星战争 2012 (美版 旧版)
lastduel	行星战争 2012 (美版 新版)
lastduelj	行星战争 2012 (日版)
plegends	豪血寺外传 - 最强传说 (美版, Ver. 95/06/20)
plegendsj	豪血寺外传 - 最强传说 (日版, Ver. 95/06/20)
powerins	豪血寺一族 (美版)
powerinsa	豪血寺一族 (美版, 盗版 第1套)
powerinsb	豪血寺一族 (美版, 盗版 第2套)
powerinsj	豪血寺一族 (日版)
pwrinst2	豪血寺一族 2 (美版, Ver. 94/04/08)
pwrinst2j	豪血寺一族 2 (日版, Ver. 94/04/08)
mslug	合金弹头 - 超级战车-001
mslug2	合金弹头 2 - 超级战车-001/II
mslug3	合金弹头 3
mslug3h	合金弹头 3 (程序未加密)
mslug3hd	合金弹头 3 (未加密, C 解密)
mslug4nd	合金弹头 4 (C 解密)
mslug4	合金弹头 4 (第1套)
mslug4h	合金弹头 4 (第2套)
ms4plus	合金弹头 4 增强型 Plus (盗版)
mslug5	合金弹头 5
mslug5h	合金弹头 5 (AES Cart)
mslug5nd	合金弹头 5 (C 解密)
ms5pcb	合金弹头 5 (JAMMA PCB)
ms5pcbnd	合金弹头 5 (JAMMA PCB, C 解密)
mslug5b	合金弹头 5 (盗版)
ms5plus	合金弹头 5 Plus (盗版)
mslug3b6	合金弹头 6 (盗版)
mslugx	合金弹头 X - 超级战车-001
metlsavr	合金救助者
nitd	黑暗守墓者 / 暗黑恶梦
nitdn	黑暗守墓者 / 暗黑恶梦 (C 解密)
nitdbl	黑暗守墓者 / 暗黑恶梦 (盗版)
darkplnt	黑暗星球
srdarwinj	黑暗之风 2 (日版)
srdarwin	黑暗之风 2 (世界版)
darktowr	黑暗之塔
blkhole	黑洞
metalbj	黑色合金 (日版)
metalb	黑色合金 (世界版)
redufo	红飞碟
exodus	红飞碟 (盗版?)
redeartn	红色地球 (961121, NO CD)
redearth	红色地球 (欧洲版, 961121)
redhawke	红鹰 (Excellent Co., Ltd)
redhawkb	红鹰 (盗版)
redhawk	红鹰 (美版)
stagger1	红鹰 (日版)
redhawki	红鹰 (意大利版)
tigeroadb	虎之道 (美版 盗版)
tigeroad	虎之道 (美版)
toramich	虎之道 (日版)
tripool	花式撞球 Tri-Pool (Casino Tech)
tripoola	花式撞球 Tri-Pool (Costal Games)
spinmast	滑轮大师 / 强尼大冒险
ponpoko	欢乐碰碰鸟
ponpokov	欢乐碰碰鸟 (Venture Line)
3in1semi	欢乐三合一 (SemiCom 3-in-1)
4in1	欢乐四合一
ecofghtru1	环保战士 (美版 931203)
ecofghtru	环保战士 (美版 940215)
uecology	环保战士 (日版 931203)
ecofghtr	环保战士 (世界版 931203)
ecofghtra	环保战士 (亚洲版 931203)
outruno	环游世界大赛车 (sitdown/upright)
outrunra	环游世界大赛车 (sitdown/直立型, Rev A)
outrun	环游世界大赛车 (sitdown/直立型, Rev B)
outrunb	环游世界大赛车 (盗版)
outrundx	环游世界大赛车 (豪华版 sitdown)
toutrun	环游世界大赛车 加速版 (驾驶舱, FD1094 317-0118)
toutrunu	环游世界大赛车 加速版 (升级版, FD1094 317-0118)
toutrun2	环游世界大赛车 加速版 (直立型, FD1094 317-未知版本)
maglord	幻魔大战 (第1套)
maglordh	幻魔大战 (第2套)
gunsmokeu	荒野大镖客 (美版 第1套)
gunsmokeua	荒野大镖客 (美版 第2套)
gunsmokej	荒野大镖客 (日版)
gunsmoke	荒野大镖客 (世界版)
dambustr	皇家空军中队 - 丹巴斯特 (美版, 第1套)
dambustra	皇家空军中队 - 丹巴斯特 (美版, 第2套)
dambustruk	皇家空军中队 - 丹巴斯特 (英国版)
wwallyja	绘本国大冒险 (rev A, 日版, FD1094 317-0197A)
wwallyj	绘本国大冒险 (rev B, 日版, FD1094 317-0197B)
contrab	魂斗罗 (盗版)
gryzor	魂斗罗 (第1套)
gryzora	魂斗罗 (第2套)
contra	魂斗罗 (美版, 第1套)
contra1	魂斗罗 (美版, 第2套)
contrajb	魂斗罗 (日版 盗版)
contraj	魂斗罗 (日版)
blazeon	魂之光辉 (日版)
phoenix	火凤凰 (Amstar)
batman2	火凤凰 蝙蝠 Part 2
kagekih	火激 (hack)
kageki	火激 (美版)
kagekij	火激 (日版)
lgtnfghtu	火龙 (美版)
trigon	火龙 (日版)
lgtnfght	火龙 (世界版)
lgtnfghta	火龙 (亚洲版)
loffireu	火线行动 - 爆弹野郎 (美版, FD1094 317-0135)
loffirej	火线行动 - 爆弹野郎 (日版, FD1094 317-0134)
loffire	火线行动 - 爆弹野郎 (世界版, FD1094 317-0136)
3countb	火线摔跤
mugsmash	火线追缉
mars	火星
mmatrix	火星 矩阵: 超固体射击 (美版 000412)
mmatrixd	火星 矩阵: 超固体射击 (日版 000412 凤凰版) (盗版)
mmatrixj	火星 矩阵: 超固体射击 (日版 000412)
firehawk	火鹰
egghunt	鸡蛋方块
sdgndmps	机动战士 SD 高达 - 塞可沙拉曼达的威胁
gundamex	机动战士高达 EX Revue
neopong	机皇弹球 (ver 1.1, Homebrew)
roboarmy	机甲神兵
armwaru1	机甲战士 / 机甲装备: 攻关版 (美版 940920)
armwaru	机甲战士 / 机甲装备: 攻关版 (美版 941024)
armwar1d	机甲战士 / 机甲装备: 攻关版 (欧洲版 941011 凤凰版) (盗版)
armwarr1	机甲战士 / 机甲装备: 攻关版 (欧洲版 941011)
armwar	机甲战士 / 机甲装备: 攻关版 (欧洲版 941024)
pgearr1	机甲战士 / 机甲装备: 攻关版 (日版 940916)
pgear	机甲战士 / 机甲装备: 攻关版 (日版 941024)
armwara	机甲战士 / 机甲装备: 攻关版 (亚洲版 940920)
cybotsu	机甲战士: 全金属狂潮 (美版 950424)
cybots	机甲战士: 全金属狂潮 (欧洲版 950424)
cybotsj	机甲战士: 全金属狂潮 (日版 950420)
tekipaki	机器人方块
dimahoud	疾风魔法大作战 (美版 000121 凤凰版) (盗版)
dimahoou	疾风魔法大作战 (美版 000121)
dimahoo	疾风魔法大作战 (欧洲版 000121)
gmahou	疾风魔法大作战 (日版 000121)
shippumd	疾风魔法大作战 (日版)
kingdmgp	疾风魔法大作战 (世界版)
overtop	极速赛车
trally	极速英豪
cannonbp	加农球 (吃豆人硬件)
omega	甲虫护蛋
checkman	检查人
checkmanj	检查人 (日版)
mosyougi	将棋达人
fireshrk	鲛! 鲛! 鲛!
samesame2	鲛! 鲛! 鲛!
samesame	鲛! 鲛! 鲛! (2 player 互换版本.)
fireshrkd	鲛! 鲛! 鲛! (韩国版, 第1套, 容易)
fireshrkdh	鲛! 鲛! 鲛! (韩国版, 第2套, 困难)
sfp	街头霸王 (工程版)
sfus	街头霸王 (美版)
sfj	街头霸王 (日版)
sf	街头霸王 (世界版)
sf2dkot2	街头霸王 II' - 四大天王 (Double K.O. Turbo II, 盗版)
sf2m10	街头霸王 II' - 四大天王 (M10, 盗版)
sf2m11	街头霸王 II' - 四大天王 (M11, 盗版)
sf2m12	街头霸王 II' - 四大天王 (M12, 盗版)
sf2m2	街头霸王 II' - 四大天王 (M2, 盗版)
sf2m3	街头霸王 II' - 四大天王 (M3, 盗版)
sf2m4	街头霸王 II' - 四大天王 (M4, 盗版)
sf2m5	街头霸王 II' - 四大天王 (M5, 盗版)
sf2m7	街头霸王 II' - 四大天王 (M7, 盗版)
sf2m8	街头霸王 II' - 四大天王 (M8, 盗版)
sf2m9	街头霸王 II' - 四大天王 (M9, 盗版)
sf2yyc	街头霸王 II' - 四大天王 (YYC, 盗版)
sf2rb	街头霸王 II' - 四大天王 (彩虹版 第1套, 盗版)
sf2rb2	街头霸王 II' - 四大天王 (彩虹版 第2套, 盗版)
sf2rb3	街头霸王 II' - 四大天王 (彩虹版 第3套, 盗版)
sf2red	街头霸王 II' - 四大天王 (赤色波动, 盗版)
sf2accp2	街头霸王 II' - 四大天王 (加速器 Pt.II, 盗版)
sf2acc	街头霸王 II' - 四大天王 (加速器!, 盗版)
sf2ceua	街头霸王 II' - 四大天王 (美版 920313)
sf2ceub	街头霸王 II' - 四大天王 (美版 920513)
sf2ceuc	街头霸王 II' - 四大天王 (美版 920803)
sf2cej	街头霸王 II' - 四大天王 (日版 920513)
sf2ce	街头霸王 II' - 四大天王 (世界版 920313)
sf2koryu	街头霸王 II' - 四大天王: 降龙 (中国 盗版 第1套)
sf2m6	街头霸王 II' - 四大天王: 降龙 (中国 盗版 第2套)
sf2tlona	街头霸王 II' - 四大天王: 屠龙 (中国 盗版 第1套)
sf2tlonb	街头霸王 II' - 四大天王: 屠龙 (中国 盗版 第2套)
sf2qp1	街头霸王 II - 天下斗士 (加速器 Pt-I, 盗版)
sf2ua	街头霸王 II - 天下斗士 (美版 910206)
sf2ub	街头霸王 II - 天下斗士 (美版 910214)
sf2ue	街头霸王 II - 天下斗士 (美版 910228)
sf2ud	街头霸王 II - 天下斗士 (美版 910318)
sf2uf	街头霸王 II - 天下斗士 (美版 910411)
sf2ui	街头霸王 II - 天下斗士 (美版 910522)
sf2uk	街头霸王 II - 天下斗士 (美版 911101)
sf2ja	街头霸王 II - 天下斗士 (日版 910214)
sf2jc	街头霸王 II - 天下斗士 (日版 910306)
sf2j	街头霸王 II - 天下斗士 (日版 911210)
sf2eb	街头霸王 II - 天下斗士 (世界版 910214)
sf2ebbl	街头霸王 II - 天下斗士 (世界版 910214, TAB 奥地利 盗版)
sf2	街头霸王 II - 天下斗士 (世界版 910522)
sf2m13	街头霸王 II' 加速版 - 战斗宣言 (M13, 盗版)
sf2t	街头霸王 II' 加速版 - 战斗宣言 (美版 921209)
sf2tj	街头霸王 II' 加速版 - 战斗宣言 (日版 921209)
sf2hf	街头霸王 II' 加速版 - 战斗宣言 (世界版 921209)
sf2v004	街头霸王 II! - 四大天王 (V004, 盗版)
sfiii2	街头霸王 III - 二度冲击 巨型攻击 (美版, 970930)
sfiii2j	街头霸王 III - 二度冲击 巨型攻击 (日版, 970930)
sfiii2n	街头霸王 III - 二度冲击 巨型攻击 (亚洲版, 970930, NO CD)
sfiii3a	街头霸王 III - 三度冲击 未来战斗 (美版, 990512)
sfiii3	街头霸王 III - 三度冲击 未来战斗 (美版, 990608)
sfiii3an	街头霸王 III - 三度冲击 未来战斗 (日版, 990512, NO CD)
sfiii3n	街头霸王 III - 三度冲击 未来战斗 (日版, 990608, NO CD)
sfiii	街头霸王 III - 新世纪 (美版, 970204)
sfiiij	街头霸王 III - 新世纪 (日版, 970204)
sfiiin	街头霸王 III - 新世纪 (亚洲版, 970204, NO CD)
streetsm1	街头快打 (美版 版本 1)
streetsm	街头快打 (美版 版本 2)
streetsmj	街头快打 (日版 版本 1)
streetsmw	街头快打 (世界版 版本 1)
strhoop	街头篮球 / 梦幻篮球赛
bssoccer	街头足球
treahunt	杰克与魔豆 (盗版?)
jack	杰克与魔豆 (第1套)
jack2	杰克与魔豆 (第2套)
jack3	杰克与魔豆 (第3套)
pclubys	解谜俱乐部 (Yun Sung, 第1套)
pclubysa	解谜俱乐部 (Yun Sung, 第2套)
puzzledp	解谜气泡
puzzldpr	解谜气泡 R
miexchng	金钱游戏
scramble	紧急起飞 混乱
scramblebf	紧急起飞 混乱 (Karateko, 法国 盗版)
scrambles	紧急起飞 混乱 (Stern)
scramb2	紧急起飞 混乱 (盗版)
strfbomb	紧急起飞 机枪炸弹
explorer	紧急起飞 探测器
joinem	精灵鬼
hotshock	惊悚狂热
bonkadv	究极 PC 原人
ajax	飓风直升机
ajaxj	飓风直升机 (日版)
typhoon	飓风直升机 Typhoon
vulgus	决战异星球 (第1套)
vulgus2	决战异星球 (第2套)
vulgusj	决战异星球 (日版?)
cadashg	卡达叙传说 (德国)
cadashf	卡达叙传说 (法国)
cadashu	卡达叙传说 (美版)
cadashj	卡达叙传说 (日版)
cadash	卡达叙传说 (世界版)
cadashi	卡达叙传说 (意大利)
karianx	卡琳魔宝 (Rev. 1.0)
karnov	卡洛夫 (美版)
karnovj	卡洛夫 (日版)
hatena	卡普空冒险问答 2 (日版 900228)
csclub1	卡普空运动俱乐部 (欧洲版 970722)
csclub	卡普空运动俱乐部 (欧洲版 971017)
csclubj	卡普空运动俱乐部 (日版 970722)
csclubjr	卡普空运动俱乐部 (日版 970722, 租借版)
csclubh	卡普空运动俱乐部 (西班牙版 970722)
cscluba	卡普空运动俱乐部 (亚洲版 970722)
galhustl	开仑骗子
pgoal	开心射门 / Futsal - 5 对 5 迷你足球
ppchamp	柯纳米迷你游戏 (韩国版)
gotcha	柯纳米迷你游戏 97
88games	柯纳米运动会 '88
konami88	柯纳米运动会 '88
stera	空间龙 (冠登陆艇 盗版)
spcdrag	空间龙 (冠登陆艇 盗版, 第1套)
spcdraga	空间龙 (冠登陆艇 盗版, 第2套)
megablstu	空间战机 (美版)
megablstj	空间战机 (日版)
megablst	空间战机 (世界版)
sbsgomo	空间战舰 - 圣骑士
airattck	空袭 (第1套)
airattcka	空袭 (第2套)
cnbe	空战代号 - 血腥天使 (060119, Homebrew)
gloc	空战神兵 (美版)
glocr360	空战神兵 R360
bgareggacn	空战之路 - Type 2 (丹麦版 / 中国版) (Tue Apr 2 1996)
bgareggat2	空战之路 - Type 2 (欧洲版 / 美版 / 日版 / 亚洲版) (Sat Mar 2 1996)
bgaregganv	空战之路 - 新版本 (奥地利版 / 香港版) (Sat Mar 2 1996)
bgareggahk	空战之路 (奥地利版 / 香港版) (Sat Feb 3 1996)
bgaregga	空战之路 (欧洲版 / 美版 / 日版 / 亚洲版) (Sat Feb 3 1996)
bgareggatw	空战之路 (台湾版 / 德国版) (Thu Feb 1 1996)
airbustrb	空中堡垒 (盗版)
airbustrj	空中堡垒 (日版)
airbustr	空中堡垒 (世界版)
skysmash	空中打击
dinorexu	恐龙传说 (美版)
dinorexj	恐龙传说 (日版)
dinorex	恐龙传说 (世界版)
dinoeh	恐龙新世纪 (hack)
dinoh	恐龙新世纪 (盗版 / hack, 第1套)
dinou	恐龙新世纪 (美版 930201)
dinoj	恐龙新世纪 (日版 930201)
dino	恐龙新世纪 (世界版 930201)
dinoha	恐龙新世纪: 97 恐龙二代 Turbo (盗版 第2套)
qtorimon	苦胃头捕物帐 (日版)
ffightb	快打旋风 (盗版)
ffightua	快打旋风 (美版 900112)
ffightub	快打旋风 (美版 900613)
ffightu	快打旋风 (美版)
ffightj2	快打旋风 (日版 900112)
ffightj1	快打旋风 (日版 900305)
ffightj	快打旋风 (日版)
ffight	快打旋风 (世界版)
spdcoin	快速硬币 (工程版)
fightfev	狂热格斗 (第1套)
fightfeva	狂热格斗 (第2套)
gemini	昆虫世界
chewing	拉霸
manybloc	拉霸拼图
bjourney	拉吉少年
lvgirl94	拉斯维加斯美女方块 (Girl '94)
qcrayon2	蜡笔小新 (日版)
blueprntj	蓝色拼图 (Jaleco)
blueprnt	蓝色拼图 (Midway)
shocking	狼人王
tigerhb1	老虎直升机 (盗版 第1套)
tigerhb2	老虎直升机 (盗版 第2套)
tigerhb3	老虎直升机 (盗版 第3套)
tigerh	老虎直升机 (美版)
tigerhj	老虎直升机 (日版)
raphero	雷豹英雄
amidar	雷达
amidaro	雷达 (Olympia)
amidaru	雷达 (Stern)
amidarb	雷达 (盗版)
amidars	雷达 (紧急起飞 硬件)
amigo	雷达 Amigo
raiden	雷电
raidenk	雷电 (韩国版)
raidena	雷电 (互换硬件)
raident	雷电 (台湾版)
tdragon1	雷龙 (4th Jun. 1991)
tdragon	雷龙 (9th Jan. 1992)
tdragonb	雷龙 (盗版)
tdragon2a	雷龙 2 (1st Oct. 1993)
tdragon2	雷龙 2 (9th Nov. 1993)
gigawingb	雷鸟之翼 (巴西版 990222)
gigawing	雷鸟之翼 (美版 990222)
gwingjd	雷鸟之翼 (日版 990223 凤凰版) (盗版)
gigawingj	雷鸟之翼 (日版 990223)
gigawinga	雷鸟之翼 (亚洲版 990222)
dogyuun	雷射战机
dogyuunk	雷射战机 (Licensed to Unite Trading For 韩国版)
thunderx	雷霆战机 (第1套)
thunderxa	雷霆战机 (第2套)
thunderxb	雷霆战机 (第3套)
thunderxj	雷霆战机 (日版)
thndrx2j	雷霆战机 II (日版)
thndrx2	雷霆战机 II (世界版)
thndrx2a	雷霆战机 II (亚洲版)
stratof	雷牙 (美版)
raiga	雷牙 (日版)
riot	雷轧斗
welltrisj	立体空间俄罗斯 (日版, 2 players)
welltris	立体空间俄罗斯 (世界版?, 2 players)
blockout	立体空间方块 (第1套)
blockout2	立体空间方块 (第2套)
blockoutj	立体空间方块 (日版)
shackled	链狱谜城 (美版)
breywood	链狱谜城 (日版 校正版 2)
turkhunt	猎鹿 USA V1.0
deerhuntc	猎鹿 USA V2
deerhuntb	猎鹿 USA V4.0
deerhunta	猎鹿 USA V4.2
deerhunt	猎鹿 USA V4.3
bshark	猎鲨行动 (美版)
bsharkj	猎鲨行动 (日版)
buzzard	猎鹰直升机
zeropnt	零式枪战 (第1套)
zeropnta	零式枪战 (第2套)
zeropnt2	零式枪战 2
zerowing	零式战机
zerowing2	零式战机 (2 player simultaneous ver.)
popspops	流行艺术
ctribeb	流氓大混战 (盗版 第1套)
ctribeb2	流氓大混战 (盗版 第2套)
ctribe1	流氓大混战 (美版 第1套?)
ctribe	流氓大混战 (美版)
ctribej	流氓大混战 (日版)
ryukyu	琉球 (日版, FD1094 317-5023)
rotd	龙吼 - 双截龙
rotdnd	龙吼 - 双截龙 (完全解密)
aof	龙虎之拳
aof2	龙虎之拳 2 (第1套)
aof2a	龙虎之拳 2 (第2套)
aof3	龙虎之拳 3 - 斗士之路 / 龙虎之拳 外传
aof3k	龙虎之拳 3 - 斗士之路 / 龙虎之拳 外传 (韩国版)
kodh	龙王战士 (盗版 / hack)
kodu	龙王战士 (美版 910910)
kodj	龙王战士 (日版 910805)
kod	龙王战士 (世界版 910711)
ddtodur1	龙与地下城 - 毁灭之塔 (美版 940113)
ddtodu	龙与地下城 - 毁灭之塔 (美版 940125)
ddtodr1	龙与地下城 - 毁灭之塔 (欧洲版 940113)
ddtodd	龙与地下城 - 毁灭之塔 (欧洲版 940412 凤凰版) (盗版)
ddtod	龙与地下城 - 毁灭之塔 (欧洲版 940412)
ddtodjr2	龙与地下城 - 毁灭之塔 (日版 940113)
ddtodjr1	龙与地下城 - 毁灭之塔 (日版 940125)
ddtodj	龙与地下城 - 毁灭之塔 (日版 940412)
ddtodhr1	龙与地下城 - 毁灭之塔 (西班牙版 940125)
ddtodh	龙与地下城 - 毁灭之塔 (西班牙版 940412)
ddtoda	龙与地下城 - 毁灭之塔 (亚洲版 940113)
ddsomb	龙与地下城 2 - 暗黑秘影 (巴西版 960223)
ddsomur1	龙与地下城 2 - 暗黑秘影 (美版 960209)
ddsomud	龙与地下城 2 - 暗黑秘影 (美版 960619 凤凰版) (盗版)
ddsomu	龙与地下城 2 - 暗黑秘影 (美版 960619)
ddsomr3	龙与地下城 2 - 暗黑秘影 (欧洲版 960208)
ddsomr2	龙与地下城 2 - 暗黑秘影 (欧洲版 960209)
ddsomr1	龙与地下城 2 - 暗黑秘影 (欧洲版 960223)
ddsom	龙与地下城 2 - 暗黑秘影 (欧洲版 960619)
ddsomjr1	龙与地下城 2 - 暗黑秘影 (日版 960206)
ddsomj	龙与地下城 2 - 暗黑秘影 (日版 960619)
ddsomh	龙与地下城 2 - 暗黑秘影 (西班牙版 960223)
ddsoma	龙与地下城 2 - 暗黑秘影 (亚洲版 960619)
qad	龙之谜题 (美版 920701)
qadj	龙之谜题 (日版 940921)
twinactn	孪生劫
croquis	逻辑 PRO (德国版)
logicpro	逻辑 PRO (日版)
logicpr2	逻辑 PRO 2 (日版)
streakng	裸奔
rockmanj	洛克人 - 力量对决 (CPS1 日版 950922)
megaman	洛克人 - 力量对决 (CPS1 亚洲版 951006)
mmancp2u	洛克人 - 力量对决 (CPS2, 美版 951006, 声音采样版)
rmancp2j	洛克人 - 力量对决 (CPS2, 日版 950922)
megamn2d	洛克人 2 - 力量对决 (美版 960708 凤凰版) (盗版)
megaman2	洛克人 2 - 力量对决 (美版 960708)
rockman2j	洛克人 2 - 力量对决 (日版 960708)
megaman2h	洛克人 2 - 力量对决 (西班牙版 960712)
megaman2a	洛克人 2 - 力量对决 (亚洲版 960708)
ssridersabd	落日骑士 (2 Players ver ABD)
ssridersebc	落日骑士 (2 Players ver EBC)
ssridersebd	落日骑士 (2 Players ver EBD)
ssridersjbd	落日骑士 (2 Players ver JBD)
ssridersubc	落日骑士 (2 Players ver UBC)
ssridersadd	落日骑士 (4 Players ver ADD)
ssriderseaa	落日骑士 (4 Players ver EAA)
ssriders	落日骑士 (4 Players ver EAC)
ssridersuac	落日骑士 (4 Players ver UAC)
ssridersuda	落日骑士 (4 Players ver UDA)
ssridersb	落日骑士 (盗版 4 Players ver ADD)
cameltryau	骆驼珠 (美版, YM2203 + M6295)
cameltry	骆驼珠 (美版, YM2610)
cameltryj	骆驼珠 (日版, YM2610)
cameltrya	骆驼珠 (世界版, YM2203 + M6295)
gberet	绿色兵团
gberetb	绿色兵团 (盗版)
rushatck	绿色兵团 (美版)
mia2	绿色兵团 2 (版本 S)
mia	绿色兵团 2 (版本 T)
miaj	绿色兵团 2 (日版)
mjgtaste	麻雀 G-体验
minasan	麻雀大富翁
mahretsu	麻雀狂列传 - 西日本编
sjryuko1	麻雀雀狼会 (第1套, 系统 16A, FD1089B 317-5021)
sjryuko	麻雀雀狼会 (第2套, 系统 16B, FD1089B 317-5021)
mgakuen	麻雀学园 - 卒业编
mgakuen2	麻雀学园 2 - 学园长的复仇
megadon	马嘉登火箭
dockman	码头工人
pitfall2	玛雅历险记 II (315-5093)
pitfall2a	玛雅历险记 II (315-5093, 小鸟妃奇 转换)
pitfall2u	玛雅历险记 II (未加密)
mangchi	曼翅
mvscb	漫画英雄 对 卡普空 - 超级英雄的冲突 (巴西版 980123)
mvscud	漫画英雄 对 卡普空 - 超级英雄的冲突 (美版 980123 凤凰版) (盗版)
mvscu	漫画英雄 对 卡普空 - 超级英雄的冲突 (美版 980123)
mvscr1	漫画英雄 对 卡普空 - 超级英雄的冲突 (欧洲版 980112)
mvsc	漫画英雄 对 卡普空 - 超级英雄的冲突 (欧洲版 980123)
mvscjr1	漫画英雄 对 卡普空 - 超级英雄的冲突 (日版 980112)
mvscj	漫画英雄 对 卡普空 - 超级英雄的冲突 (日版 980123)
mvsch	漫画英雄 对 卡普空 - 超级英雄的冲突 (西班牙版 980123)
mvscar1	漫画英雄 对 卡普空 - 超级英雄的冲突 (亚洲版 980112)
mvsca	漫画英雄 对 卡普空 - 超级英雄的冲突 (亚洲版 980123)
kbash	猫王
kbash2	猫王 2 (盗版)
gumbo	美女方块
paprazzi	美女杀手
mspuzzle	美少女解谜拼图
mspuzzlen	美少女解谜拼图 (裸女)
mspuzzleg	美少女解谜拼图 (美女方块的克隆)
sailormno	美少女战士 - 水手月亮 (JUEHTK, Ver. 95/03/22)
sailormn	美少女战士 - 水手月亮 (JUEHTK, Ver. 95/03/22B)
nemoj	梦幻冒险 (日版 901120)
nemo	梦幻冒险 (世界版 901130)
twinspri	梦幻小妖精
kikcubicb	迷宫岛
kikcubic	迷宫岛 (日版)
dorodon	迷宫精灵 (第1套)
dorodon2	迷宫精灵 (第2套)
ghostb	迷宫猎人 G (美版 2 Players)
ghostb3	迷宫猎人 G (美版 3 Players)
meikyuh	迷宫猎人 G (日版, 第1套)
meikyuha	迷宫猎人 G (日版, 第2套)
minivadr	迷你小蜜蜂
pzloop2	谜球回路 2 (欧洲版 010302)
pzloop2j	谜球回路 2 (日版 010205)
honeydol	蜜蜂玩偶
myststono	秘石 - 奇克博士的冒险
mystston	秘石 - 约翰博士的冒险
cottonj	棉花小魔女 (第1套, 日版, FD1094 317-0179a)
cottonu	棉花小魔女 (第2套, 美版, FD1094 317-0180)
cotton	棉花小魔女 (第3套, 世界版, FD1094 317-0181a)
captcommu	名将 (美版 910928)
captcommj	名将 (日版 911202)
captcomm	名将 (世界版 911014)
meijinsn	名人战
hexa	魔法宝石 Hexa
mahoudai	魔法大作战 (日版)
sstriker	魔法大作战 (世界版)
sstrikera	魔法大作战 (世界版, 替换版)
pnickj	魔法方块 (日版 940608)
mswordu	魔法剑 - 英雄的幻想 (美版 900725)
mswordr1	魔法剑 - 英雄的幻想 (世界版 900623)
msword	魔法剑 - 英雄的幻想 (世界版 900725)
mswordj	魔法剑 (日版 900623)
htchctch	魔法绿兵卫
news	魔法美女气泡 (第1套)
newsa	魔法美女气泡 (第2套)
magicbub	魔法泡泡
magicbuba	魔法泡泡 (成人版)
magdrop2	魔法气泡 II
magdrop3	魔法气泡 III
mgcrystlj	魔法水晶 (日版, 92/01/13)
mgcrystlo	魔法水晶 (世界版, 91/12/10)
mgcrystl	魔法水晶 (世界版, 92/01/10)
racknrol	魔法台球
hexpoola	魔法台球 (Senko)
hexpool	魔法台球 (Shinkai)
pangb	魔鬼气泡 (盗版, 第1套)
pangbold	魔鬼气泡 (盗版, 第2套)
bbros	魔鬼气泡 (美版)
pompingw	魔鬼气泡 (日版)
pang	魔鬼气泡 (世界版)
pang3n	魔鬼气泡 3 (欧洲版 950511, 未加密)
pang3	魔鬼气泡 3 (欧洲版 950601)
pang3j	魔鬼气泡 3 (日版 950511)
chokchok	魔鬼气泡海中对战
genix	魔鬼气泡牛仔版
gpilots	魔鬼战将 / 幽灵战区 (第1套)
gpilotsh	魔鬼战将 / 幽灵战区 (第2套)
bublbobl	魔幻气泡
bublbobl1	魔幻气泡 (旧版)
bublboblr	魔幻气泡 (美版 有选择模式)
bublboblr1	魔幻气泡 (美版)
boblbobl	魔幻气泡 / Bobble Bobble
puzlstar	魔幻星座 (ver. 100MG)
gngbl	魔界村 (盗版 with Cross)
gngt	魔界村 (美版)
makaimurc	魔界村 (日版 校正版 C)
makaimurg	魔界村 (日版 校正版 G)
makaimur	魔界村 (日版)
gng	魔界村 (世界版? 第1套)
gnga	魔界村 (世界版? 第2套)
gngc	魔界村 (世界版? 第3套)
gngblita	魔界村 (意大利 盗版, 硬件)
gondo	魔境战士 - 绝对合体 (美版)
makyosen	魔境战士 - 绝对合体 (日版)
mcatadv	魔猫森林
mcatadvj	魔猫森林 (日版)
catt	魔猫森林 Catt (日版)
devilfsh	魔神鱼类
devilfsg	魔神鱼类 (Galaxian 硬件, 盗版?)
majuu	魔兽王国
darkadv	魔兽王国 Dark Adventure
devilw	魔兽王国 Devil 世界版
kotm	魔兽之王 (第1套)
kotmh	魔兽之王 (第2套)
kotm2	魔兽之王 2
rachero	摩托英雄 (FD1094 317-0144)
scorpionmc	魔蝎 (Moon Cresta 硬件)
scorpion	魔蝎 (第1套)
scorpiona	魔蝎 (第2套)
scorpionb	魔蝎 (第3套)
dondokodu	木匠兄弟 (美版)
dondokodj	木匠兄弟 (日版)
dondokod	木匠兄弟 (世界版)
lastblad	幕末浪漫 月华剑士 (第1套)
lastbladh	幕末浪漫 月华剑士 (第2套)
lastbld2	幕末浪漫第二幕 月华剑士 - 月中芳华,散落月下
nouryoku	脑力向上委员会
pspikes2	能量排球 2
progear	能源之岚 (美版 010117)
progerjd	能源之岚 (日版 010117 凤凰版) (盗版)
progearj	能源之岚 (日版 010117)
progeara	能源之岚 (亚洲版 010117)
tnzsjo	纽西兰童话 (日版, 旧版) (旧版 PCB)
tnzsj	纽西兰童话 (日版, 新版) (新版 PCB)
tnzsop	纽西兰童话 (世界版, 工程版?) (旧版 PCB)
tnzso	纽西兰童话 (世界版, 旧版) (旧版 PCB)
tnzs	纽西兰童话 (世界版, 新版) (新版 PCB)
farmer	农夫叛乱物语
ikki	农夫叛乱物语 (日版)
ikari3nr	怒 III - 援救 (8-Way 操纵杆)
ikari3	怒 III (Rotary 操纵杆)
ddonpach	怒首领蜂 (国际版, Master Ver. 97/02/05)
ddonpachj	怒首领蜂 (日版, Master Ver. 97/02/05)
onna34ro	女三四郎 (第1套)
onna34roa	女三四郎 (第2套)
bodyslam	女子摔角 (8751 317-0015)
dumpmtmt	女子摔角 (日版, 8751 317-0011a)
fr2ch	偶像麻雀 - 最终罗曼史 2 (CD to MVS Conversion, Hack)
scramblb	爬行 (盗版 Galaxian 硬件)
rockclim	攀岩者
pangpang	乓乓
punkshot2	庞克篮球 (美版 2 Players)
punkshot	庞克篮球 (美版 4 Players)
punkshotj	庞克篮球 (日版 2 Players)
gunnail	炮钉 (28th May. 1992)
pzlbowl	泡泡保龄球 (日版)
pbobblenb	泡泡龙 (Neo-Geo) (盗版)
pbobblen	泡泡龙 (Neo-Geo) (第1套)
pbobbl2n	泡泡龙 2 (Neo-Geo)
bubl2000	泡泡野人版 2000
hotbubl	泡泡野人版 Hot
bangbead	碰碰球
bngbeadn	碰碰球 (C 解密)
bangbedp	碰碰球 (工程版)
flashgal	霹雳娇娃 (第1套)
flashgala	霹雳娇娃 (第2套)
eswatbl	霹雳双警 (盗版)
eswatj	霹雳双警 (第1套, 日版, FD1094 317-0128)
eswatu	霹雳双警 (第2套, 美版, FD1094 317-0129)
eswat	霹雳双警 (第3套, 世界版, FD1094 317-0130)
theroes	霹雳英雄
ladybugg	瓢虫小姐 (盗版 Galaxian 硬件)
acitya	扑克 21 点 Atlantic City Action
bwcasino	扑克 21 点 Boardwalk Casino
poknight	扑克之夜 (Homebrew, 没有声音)
pulirulaj	普利路拉传说 (日版)
pulirula	普利路拉传说 (世界版)
7toitsu	七对子 - 一万去还有一万
drgnbowl	七龙珠
wakuwak7	七战士 / 火热火热 7
wndrplnt	奇幻星球 (日版)
3wondersh	奇迹三合一 (hack?)
3wondersu	奇迹三合一 (美版 910520)
wonder3	奇迹三合一 (日版 910520)
3wonders	奇迹三合一 (世界版 910520)
wondstck	奇迹手杖
wondl96	奇妙联盟 '96 (韩国版)
wlstar	奇妙联盟之星 (韩国版)
suratkj	奇袭 - 星战大怒吼 (日版 ver. M)
suratk	奇袭 - 星战大怒吼 (世界版 ver. K)
suratka	奇袭 - 星战大怒吼 (亚洲版 ver. L)
cavelon	骑士之剑
pkunwar	企鹅大战 (美版)
pkunwarj	企鹅大战 (日版)
penbros	企鹅兄弟 (日版)
ballbros	气球兄弟
ginkun	前代末间大爆笑
diverboy	潜水宝宝
calipso	潜水任务
gigandes	潜艇卫星
gigandesj	潜艇卫星 (日版)
gunfrontj	枪之国度 (日版)
gunfront	枪之国度 (世界版)
igmo	抢救同伴
blockbl	敲砖块 (盗版)
blockj	敲砖块 (日版 910910)
block	敲砖块 (世界版 911106 操纵杆)
blockjoy	敲砖块 (世界版 911106 操纵杆, Bad Dump?)
jojobane	乔乔的奇妙冒险 - 未来遗产 (欧洲版, 990913, NO CD)
jojoba	乔乔的奇妙冒险 - 未来遗产 (日版, 990913)
jojoban	乔乔的奇妙冒险 - 未来遗产 (日版, 990913, NO CD)
jojoa	乔乔的奇妙冒险 (日版, 981202)
jojo	乔乔的奇妙冒险 (日版, 990108)
jojoan	乔乔的奇妙冒险 (亚洲版, 981202, NO CD)
jojon	乔乔的奇妙冒险 (亚洲版, 990108, NO CD)
retofinv	侵略者回归
retofinv1	侵略者回归 (盗版 第1套)
retofinv2	侵略者回归 (盗版 第2套)
retofin3	侵略者回归 (盗版 第3套)
sscandal	青春物语 (315-5132, 日版)
froggers	青蛙过河
frogger	青蛙过河
frogf	青蛙过河 (Falcon 盗版)
frogg	青蛙过河 (Galaxian 硬件)
froggermc	青蛙过河 (Moon Cresta 硬件)
froggers1	青蛙过河 (Sega 第1套)
froggers2	青蛙过河 (Sega 第2套)
loverboy	求爱男孩
cookbib	曲吉鼠解谜
cookbib2	曲吉鼠解谜 2
cookbib3	曲吉鼠解谜 3
kof2000	拳皇 2000
kof2knd	拳皇 2000 (C 解密)
kof2000n	拳皇 2000 (程序未加密)
kof2001	拳皇 2001 (第1套)
kof2001h	拳皇 2001 (第2套)
kof2k1nd	拳皇 2001 (完全解密)
kf2k1pa	拳皇 2001 风云再起 Plus (盗版 / 第2套)
kf2k1pls	拳皇 2001 增强型 Plus (盗版 / 第1套)
kof2002	拳皇 2002 - 终极挑战
kf2k2ps2	拳皇 2002 - 终极挑战 (PlayStation 2 ver 0.4, EGHT hack)
kof2002b	拳皇 2002 - 终极挑战 (盗版)
kof2k2nd	拳皇 2002 - 终极挑战 (完全解密)
kf2k2mp	拳皇 2002 - 终极挑战 Magic Plus (盗版)
kf2k2mp2	拳皇 2002 - 终极挑战 Magic Plus II (盗版)
kf2k2plb	拳皇 2002 - 终极挑战 Plus (盗版 / 第3套)
kf2k2plc	拳皇 2002 - 终极挑战 Super (盗版 / 第4套)
kf2k2pls	拳皇 2002 - 终极挑战 风云再起 (盗版 第1套)
kf2k2pla	拳皇 2002 - 终极挑战 风云再起 Plus (盗版 第2套)
kf2k3bl	拳皇 2003 (盗版 第1套)
kf2k3bla	拳皇 2003 (盗版 第2套)
kof2003	拳皇 2003 (第1套)
kof2003h	拳皇 2003 (第2套)
kf2k3pcb	拳皇 2003 (日版, JAMMA PCB)
k2k3pcbd	拳皇 2003 (日版, JAMMA PCB, C 解密)
kof2k3nd	拳皇 2003 (完全解密)
kf2k3pl	拳皇 2004 EX Hero (盗版)
kf2k3upl	拳皇 2004 EX 风云 Plus (盗版)
kof94	拳皇 '94
kof95	拳皇 '95 (第1套)
kof95h	拳皇 '95 (第2套)
kof95a	拳皇 '95 (第2套)
kof96ae	拳皇 '96 (Anniversary Edition, EGHT hack)
kof96ep	拳皇 '96 (盗版 / hack)
kof96	拳皇 '96 (第1套)
kof96h	拳皇 '96 (第2套)
kof96cn	拳皇 '96 (中文版 1.0, hack)
kof97xt	拳皇 '97 - 最终の决战 (hack)
kof97	拳皇 '97 (第1套)
kof97h	拳皇 '97 (第2套)
kof97pls	拳皇 '97 风云再起 Plus (盗版)
kof97cn	拳皇 '97 十周年中文版 (EGHT hack)
kof97pla	拳皇 '97 重出江湖 Plus 2003 (盗版)
kof98	拳皇 '98 - 梦战斗未结束
kof98ae	拳皇 '98 - 梦战斗未结束 (Anniversary Edition, EGHT hack)
kof98k	拳皇 '98 - 梦战斗未结束 (韩国机板)
kof98n	拳皇 '98 - 梦战斗未结束 (未加密)
kof99n	拳皇 '99 - 千年之战 (程序未加密)
kof99	拳皇 '99 - 千年之战 (第1套)
kof99a	拳皇 '99 - 千年之战 (第2套)
kof99p	拳皇 '99 - 千年之战 (工程版)
kof99nd	拳皇 '99 - 千年之战 (完全解密)
kof99e	拳皇 '99 - 千年之战 (早期版本)
svcpcbnd	拳皇 vs. 街霸 (JAMMA PCB, 第1套, C 解密)
svcnd	拳皇 vs. 街霸 (完全解密)
svc	拳皇 对 街霸
svcpcb	拳皇 对 街霸 (JAMMA PCB, 第1套)
svcpcba	拳皇 对 街霸 (JAMMA PCB, 第2套)
svcboot	拳皇 对 街霸 (盗版)
svcsplus	拳皇 对 街霸 超级加强版 (盗版)
svcplus	拳皇 对 街霸 加强版 (盗版 第1套)
svcplusa	拳皇 对 街霸 加强版 (盗版 第2套)
kof10th	拳皇 十周年纪念 - 所有队伍的战斗 (盗版)
kf2k5uni	拳皇 十周年纪念 - 所有队伍的战斗 2005 Unique (盗版)
kf10thep	拳皇 十周年纪念 - 所有队伍的战斗 Extra Plus (盗版)
kof2k4se	拳皇 特别版 2004 (盗版)
kf2k4pls	拳皇 特别版 2004 风云再起 (盗版)
quizkof	拳皇问答
froundl	拳击决赛 (版本 L)
fround	拳击决赛 (版本 M)
hpuncher	拳击决赛 (日版)
mainevt2p	拳击擂台 (2 Players ver. X)
mainevto	拳击擂台 (4 Players ver. F)
mainevt	拳击擂台 (4 Players ver. Y)
ringohja	拳击擂台 (日版 2 Players ver. N)
jyangoku	雀国志: 覇王の采牌 (日版 990527)
janshin	雀神传说 - 寻找麻将大师
burningf	热血快打 (第1套)
burningfh	热血快打 (第2套)
renegade	热血硬派 (美版)
kuniokunb	热血硬派 (日版 盗版)
kuniokun	热血硬派 (日版)
ninja	忍者 (315-5102)
ncombat	忍者大战 (第1套)
ncombath	忍者大战 (第2套)
nprinces	忍者公主 (315-5051, 64k Ver. 盗版?)
nprincesb	忍者公主 (315-5051?, 128k Ver. 盗版?)
nprinceso	忍者公主 (315-5098, 128k Ver.)
nprincesu	忍者公主 (64k Ver. 未加密)
gaiden	忍者龙剑传 (美版)
ryukendn	忍者龙剑传 (日版, 第1套)
ryukendna	忍者龙剑传 (日版, 第2套)
shadoww	忍者龙剑传 (世界版, 第1套)
shadowwa	忍者龙剑传 (世界版, 第2套)
tmnt2po	忍者神龟 (大洋洲版 2 Players)
tmntu	忍者神龟 (美版 4 Players, 第1套)
tmntua	忍者神龟 (美版 4 Players, 第2套)
tmnt2pj	忍者神龟 (日版 2 Players)
tmntj	忍者神龟 (日版 4 Players)
tmnt	忍者神龟 (世界版 4 Players)
tmht2p	忍者神龟 (英国版 2 Players, 第1套)
tmht2pa	忍者神龟 (英国版 2 Players, 第2套)
tmht	忍者神龟 (英国版 4 Players)
tmht22pe	忍者神龟 2 (2 Players ver EBA)
tmnt22pu	忍者神龟 2 (2 Players ver UDA)
tmnt2a	忍者神龟 2 (4 Players ver ADA)
tmnt2	忍者神龟 2 (4 Players ver UAA)
ninjawj	忍者武士 (日版)
ninjaw	忍者武士 (世界版)
ninjaku	忍者小子 (美版)
ninjakj	忍者小子 (日版)
ninjak	忍者小子 (世界版)
ncommand	忍者战士
choko	日本益智麻将牌 - 长江 (日版 010820)
mj4simai	若草物语 - 麻雀四姊妹 (日版)
mofflott	赛车迷宫 (日版)
stakwin	赛马大亨 / 赏金猎手 - GI 完全制霸之道
stakwin2	赛马大亨 / 赏金猎手 2
kovsh103	三国战纪 - 风云再起 (ver. 103)
kovsh	三国战纪 - 风云再起 (ver. 104)
kovqhsgs	三国战纪 - 拳皇三国 特别版 (ver. 303CN)
kovj	三国战纪 (ver. 100, 日文基版)
kov115	三国战纪 (ver. 115)
kov	三国战纪 (ver. 117)
kov2p	三国战纪 2 - 群雄争霸 (ver. M204XX)
kov2p205	三国战纪 2 - 群雄争霸 (ver. M205XX)
kov2	三国战纪 2 (ver. 100)
kov2a	三国战纪 2 (ver. 101)
kov2106	三国战纪 2 (ver. 106)
kovplusa	三国战纪 正宗 Plus (ver. 119 替换版)
kovplus	三国战纪 正宗 Plus (ver. 119)
wofjh	三国志 II - 赤壁之战 (Tenchi wo Kurau 2 921031 日版 盗版)
wofu	三国志 II (美版 921031)
wof	三国志 II (世界版 921002)
wofa	三国志 II (亚洲版 921005)
wofhfh	三国志 II: 火凤凰 (中国 盗版)
wof3js	三国志 II: 三剑圣 (中国 盗版)
wofah	三国志II (Sangokushi 2 921005 亚洲版 盗版 第2套)
spatter	三轮车物语
ssanchan	三轮车物语 (日版)
growlu	森林保护神 (美版)
runark	森林保护神 (日版)
growl	森林保护神 (世界版)
insectx	杀虫战记 (世界版)
desertbr	沙漠王 (FD1094 317-0196)
bakatono	傻瓜殿下麻雀漫游记
twinkle	闪亮小精灵
blazstar	闪亮之星 / 炽热星空
dealer	商品买卖
sfzbr1	少年街霸 (巴西版 950727)
sfzb	少年街霸 (巴西版 951109)
sfzjr2	少年街霸 (日版 950605)
sfzjr1	少年街霸 (日版 950627)
sfzj	少年街霸 (日版 950727)
sfzh	少年街霸 (西班牙版 950627)
sfza	少年街霸 (亚洲版 950627)
sfz2br1	少年街霸 2 (巴西版 960304)
sfz2b	少年街霸 2 (巴西版 960531)
sfz2n	少年街霸 2 (大洋洲版 960229)
sfa2u	少年街霸 2 (美版 960306)
sfa2	少年街霸 2 (欧洲版 960229)
sfz2j	少年街霸 2 (日版 960227)
sfz2h	少年街霸 2 (西班牙版 960304)
sfz2ad	少年街霸 2 (亚洲版 960227 凤凰版) (盗版)
sfz2a	少年街霸 2 (亚洲版 960227)
sfz2alb	少年街霸 2 Alpha (巴西版 960813)
sfz2alj	少年街霸 2 Alpha (日版 960805)
sfz2alh	少年街霸 2 Alpha (西班牙版 960813)
sfz2ald	少年街霸 2 Alpha (亚洲版 960826 凤凰版) (盗版)
sfz2al	少年街霸 2 Alpha (亚洲版 960826)
sfa3b	少年街霸 3 (巴西版 980629)
sfa3ur1	少年街霸 3 (美版 980629)
sfa3ud	少年街霸 3 (美版 980904 凤凰版) (盗版)
sfa3u	少年街霸 3 (美版 980904)
sfa3	少年街霸 3 (欧洲版 980904)
sfz3jr2	少年街霸 3 (日版 980629)
sfz3jr1	少年街霸 3 (日版 980727)
sfz3j	少年街霸 3 (日版 980904)
sfz3ar1	少年街霸 3 (亚洲版 980701)
sfz3a	少年街霸 3 (亚洲版 980904)
sfau	少年街霸: 斗士之梦 (美版 950627)
sfar3	少年街霸: 斗士之梦 (欧洲版 950605)
sfar2	少年街霸: 斗士之梦 (欧洲版 950627)
sfar1	少年街霸: 斗士之梦 (欧洲版 950718)
sfad	少年街霸: 斗士之梦 (欧洲版 950727 凤凰版) (盗版)
sfa	少年街霸: 斗士之梦 (欧洲版 950727)
eggor	射蛋
goalx3	射门! 射门! 射门!
theend	射蜘蛛
theends	射蜘蛛 (Stern)
vandykejal	神话战士 (Jaleco, 第1套)
vandykejal2	神话战士 (Jaleco, 第2套)
vandykeb	神话战士 (盗版 PIC16c57)
vandyke	神话战士 (日版)
ragnagrd	神凰拳
fantzone1	神奇地带 (第1套, 未保护版)
fantzone	神奇地带 (第2套, 未保护版)
wboy4	神奇男孩 (315-5162, 四次元战士 转换)
wboyo	神奇男孩 (第1套, 315-5135)
wboy	神奇男孩 (第1套, 315-5177)
wboy2	神奇男孩 (第2套, 315-5178)
wboy2u	神奇男孩 (第2套, 未加密)
wboy3	神奇男孩 (第3套, 315-5135)
wboyu	神奇男孩 (工程版?)
wb31	神奇男孩 III - 在魔界 (第1套, 系统 16A, FD1094 317-0084)
wb32	神奇男孩 III - 在魔界 (第2套, 日版, 系统 16B, FD1094 317-0085)
wb33	神奇男孩 III - 在魔界 (第3套, 世界版, 系统 16B, FD1094 317-0089)
wb34	神奇男孩 III - 在魔界 (第4套, 日版, 系统 16B, FD1094 317-0087)
wb3	神奇男孩 III - 在魔界 (第5套, 世界版, 系统 16B, 8751 317-0098)
wbdeluxe	神奇男孩豪华版
biomtoy	生化玩具兵 (未保护版)
bioship	生化战舰 - 圣骑士
gauntlet2pr3	圣铠 (2 Players, rev 3)
gauntlet2p	圣铠 (2 Players, rev 6)
gauntlet2pg1	圣铠 (2 Players, 德国版, rev 1)
gauntlet2pg	圣铠 (2 Players, 德国版, rev 4)
gauntlet2pj2	圣铠 (2 Players, 日版, rev 2)
gauntlet2pj	圣铠 (2 Players, 日版, rev 5)
gauntletr1	圣铠 (rev 1)
gauntlet	圣铠 (rev 14)
gauntletr2	圣铠 (rev 2)
gauntletr4	圣铠 (rev 4)
gauntletr5	圣铠 (rev 5)
gauntletr7	圣铠 (rev 7)
gauntletr9	圣铠 (rev 9)
gauntletg	圣铠 (德国版, rev 10)
gauntletgr3	圣铠 (德国版, rev 3)
gauntletgr6	圣铠 (德国版, rev 6)
gauntletgr8	圣铠 (德国版, rev 8)
gauntletj12	圣铠 (日版, rev 12)
gauntletj	圣铠 (日版, rev 13)
gauntlets	圣铠 (西班牙版, rev 15)
gaunt2	圣铠 II
gaunt22p1	圣铠 II (2 Players, rev 1)
gaunt22p	圣铠 II (2 Players, rev 2)
gaunt22pg	圣铠 II (2 Players, 德国版)
gaunt2g	圣铠 II (德国版)
victnine	胜利棒球
trophyh	胜利打猎 - 熊 & 鹿 V1.0
mjnquestb	圣雀士龙子 (非脱衣版)
mjnquest	圣雀士龙子 (日版)
crsword	圣十字剑
grdnstrm	圣战 - 守护风暴
grdnstrmk	圣战 - 守护风暴 (韩国版)
forgottnu	失落的世界 (美版)
lostwrld	失落的世界 (日版)
forgottn	失落的世界 (世界版)
mrviking	失落的维京人 (315-5041)
mrvikingj	失落的维京人 (315-5041, 日版)
timescan1	时空弹珠台 (第1套, 系统 16A, FD1089B 317-0024)
timescan	时空弹珠台 (第2套, 系统 16B)
sharrier1	时空哈利 (8751 317-0063?)
sharrier	时空哈利 (Rev A, 8751 317-0063A?)
spinlbrku	时空英雄 (美版)
spinlbrkj	时空英雄 (日版)
spinlbrk	时空英雄 (世界版)
livequiz	实况问答秀
agallet	石破天惊 (JUEHTK)
anteater	食蚁兽
anteatg	食蚁兽 (德国版)
anteatgb	食蚁兽 (英国版)
samsho	侍魂 - 十二剑手 (第1套)
samshoh	侍魂 - 十二剑手 (第2套)
samsho5b	侍魂 Ⅴ / 侍魂 零 (盗版)
samsho5	侍魂 Ⅴ / 侍魂 零 (第1套)
samsho5h	侍魂 Ⅴ / 侍魂 零 (第2套)
samsh5nd	侍魂 Ⅴ / 侍魂 零 (完全解密)
ss5shnd	侍魂 Ⅴ SPECIAL / 侍魂 零 特别版 (C 解密)
samsh5sp	侍魂 Ⅴ SPECIAL / 侍魂 零 特别版 (第1套 未删减版)
samsh5sph	侍魂 Ⅴ SPECIAL / 侍魂 零 特别版 (第2套, 删减版)
samsh5spn	侍魂 Ⅴ SPECIAL / 侍魂 零 特别版 (第3套 少量删减版)
samsho2	侍魂 II / 真侍魂 - 霸王丸地狱变
samsho3	侍魂 III / 侍魂 - 斩红郎无双剑 (第1套)
samsho3h	侍魂 III / 侍魂 - 斩红郎无双剑 (第2套)
samsho4	侍魂 IV - 天草降临
mimonkey	世纪猴王
mimonsco	世纪猴王 (盗版 on Super Cobra 硬件)
mimonscr	世纪猴王 (盗版 紧急起飞 硬件)
fpoint1	世嘉俄罗斯方块解谜 (第1套, 日版, FD1094 317-0127A)
fpoint	世嘉俄罗斯方块解谜 (第2套, 日版, FD1094 317-0127A)
fpointbj	世嘉俄罗斯方块解谜 (日版, 盗版)
fpointbl	世嘉俄罗斯方块解谜 (世界版, 盗版)
hangon1	世嘉摩托车大赛
hangon	世嘉摩托车大赛 (Rev A)
seganinj	世嘉忍者 (315-5102)
seganinju	世嘉忍者 (未加密)
enduror	世嘉越野机车赛 (YM2151, FD1089B 317-0013A)
enduror1	世嘉越野机车赛 (YM2203, FD1089B 317-0013A)
endurobl	世嘉越野机车赛 (盗版 第1套)
bottom9n	世界棒球 (版本 N)
bottom9	世界棒球 (版本 T)
mstadium	世界棒球 (日版)
wc90t	世界杯足球 '90 (trackball 第1套)
wc90a	世界杯足球 '90 (欧洲版 第1套)
wc90b	世界杯足球 '90 (欧洲版 第2套)
wc90	世界杯足球 '90 (世界版)
btlkroad	世界武术格斗比赛
wh1	世界英雄 (第1套)
wh1h	世界英雄 (第2套)
wh1ha	世界英雄 (第3套)
wh2	世界英雄 2
wh2j	世界英雄 2 喷射版 (第1套)
wh2jh	世界英雄 2 喷射版 (第2套)
whp	世界英雄 完美版
donpachikr	首领蜂 (韩国版)
donpachi	首领蜂 (美版)
donpachij	首领蜂 (日版)
donpachihk	首领蜂 (香港版)
altbeast2	兽王记 (第2套, MC-8123B 317-0066)
altbeastj3	兽王记 (第3套, 日版, FD1094 317-0068)
altbeast4	兽王记 (第4套, MC-8123B 317-0066)
altbeast5	兽王记 (第5套, 8751 317-0076)
altbeastj	兽王记 (第6套, 日版, 8751 317-0077)
altbeast	兽王记 (第7套, 8751 317-0078)
mbomberj	摔跤霸王 - 肌肉爆弹 (日版 930713)
mbombrdj	摔跤霸王 - 热力战士 (日版 931206)
mbombrd	摔跤霸王 - 最终之战 (世界版 931206)
slammastu	摔跤霸王 (美版 930713)
slammast	摔跤霸王 (世界版 930713)
ringdstd	摔跤霸王 II (欧洲版 940902 凤凰版) (盗版)
ringdest	摔跤霸王 II (欧洲版 940902)
smbombr1	摔跤霸王 II (日版 940808)
smbomb	摔跤霸王 II (日版 940831)
wrestwar1	摔跤大战 (第1套, 日版, FD1094 317-0090)
wrestwar2	摔跤大战 (第2套, 世界版, FD1094 317-0102)
wrestwar	摔跤大战 (第3套, 世界版, 8751 317-0103)
doubledr	双截龙 (Neo-Geo)
ddragonb	双截龙 (盗版 HD6309)
ddragonba	双截龙 (盗版 M6803)
ddragonb2	双截龙 (盗版)
ddragonu	双截龙 (美版 第1套)
ddragonua	双截龙 (美版 第2套)
ddragon	双截龙 (日版)
ddragonw	双截龙 (世界版 第1套)
ddragonw1	双截龙 (世界版 第2套)
ddragon3b	双截龙 3 - 罗塞塔之石 (盗版)
ddragon3p	双截龙 3 - 罗塞塔之石 (工程版)
ddragon3	双截龙 3 - 罗塞塔之石 (美版)
ddragon3j	双截龙 3 - 罗塞塔之石 (日版)
ddragon2u	双截龙 II - 复仇 (美版)
ddragon2	双截龙 II - 复仇 (世界版)
chikij	双麒儿 (日版 900619)
mtwins	双麒儿 (世界版 900619)
pisces	双鱼座
piscesb	双鱼座 (盗版)
omni	双鱼座 Omni
theglob	水滴
theglob2	水滴 (早期版)
silkroad	丝绸之路
deadconxj	死亡边缘 (日版)
deadconx	死亡边缘 (世界版)
pulstar	死亡之星 / 惑星战机
4dwarrio	四次元战士 (315-5162)
aerofgt	四国战机
aerofgtb	四国战机 (加速力量 硬件 第1套)
aerofgtc	四国战机 (加速力量 硬件 第2套)
sonicwi	四国战机 (日版)
sonicwi2	四国战机 2 / 音速之翼 2
sonicwi3	四国战机 3 / 音速之翼 3
4enraya	四连线
dblaxle	四驱赛车 (美版)
pwheelsj	四驱赛车 (日版)
taotaido	苏婆诃格斗 - 太鸥体道 (第1套)
taotaidoa	苏婆诃格斗 - 太鸥体道 (第2套)
solomon	所罗门之钥 (美版)
solomonj	所罗门之钥 (日版)
teddybbo	泰迪男孩布鲁斯 (315-5115, 旧版)
teddybb	泰迪男孩布鲁斯 (315-5115, 新版)
brain	太空登陆战
speakres	太空防卫 - Speak & Rescue
stratvox	太空防卫 - Stratovox
stratvoxb	太空防卫 - Stratovox (盗版)
spacecho	太空防卫 (第1套)
ad2083	太空核战 2083
sraider	太空雷达
freeze	太空人迷宫
spcpostn	太空赛车 (日版)
gyrussce	太空射击战 (Centuri)
gyruss	太空射击战 (Konami)
venus	太空射击战 Venus
spacegun	太空神枪 (世界版)
sbomberb	太空炸弹 (ver. B)
dariuse	太空战斗机 (额外版) (日版)
dariuso	太空战斗机 (日版 旧版)
dariusj	太空战斗机 (日版)
darius	太空战斗机 (世界版)
darius2	太空战斗机 II (日版)
soldivid	太阳表决
snapper	贪食蛇 - 鳄龟 (韩国版)
drtomy	汤米医生
tangtang	堂堂 (版本. 0526, 26/05/2000)
scinegro	特别刑事调查组 (Negro 盗版)
sciu	特别刑事调查组 (美版)
scij	特别刑事调查组 (日版)
sci	特别刑事调查组 (世界版 第1套)
scia	特别刑事调查组 (世界版 第2套)
galpanic	天蚕变 (未保护)
newfant	天蚕变 95 - 新幻想曲
missmw96	天蚕变 '96 - 世界先生 + 世界小姐篇 (裸体)
missw96	天蚕变 '96 (裸体)
wownfant	天蚕变 新幻想曲
fantasia	天蚕变幻想曲
supmodel	天蚕变幻想曲 - 超级名模特
fantsy95	天蚕变幻想曲 95
fantsia2a	天蚕变幻想曲 II (较明确)
fantsia2	天蚕变幻想曲 II (明确)
skyfox	天狐
exerizrb	天狐 (日版) (盗版)
skybase	天空基地
skylancr	天空雷射枪
skylancre	天空雷射枪 (Esco Trading Co license)
alexkidd1	天空魔城 (第1套, FD1089A 317-unknown)
alexkidd	天空魔城 (第2套, 未保护版)
ohmygod	天神方块 (日版)
angelkds	天使奇妙冒险 (日版)
skykidd	天堂鸟 (CUS60 版)
skykids	天堂鸟 (Sipem)
skykido	天堂鸟 (旧版)
skykid	天堂鸟 (新版)
kabukikl	天外魔境真传 - 东方伊甸园
jumpbug	跳跳车
jumpbugb	跳跳车 (盗版)
popbounc	跳跳球 / 动物方块
jumpshot	跳跃篮球
jumpshtp	跳跃篮球 Engineering Sample
jumpkids	跳跃顽童
rchase	铁道逃生 (日版)
mazinger	铁甲万能侠 Z (国际版/日版)
pkladies	同花顺
pkladiesla	同花顺 (Leprechaun ver. 401)
pkladiesl	同花顺 (Leprechaun ver. 510)
aodk	痛快 GANGAN 进行曲 / 热血进行曲
hedpanic	头槌小子 (版本. 0117, 17/01/2000)
hedpanicf	头槌小子 (版本. 0315, 15/03/2000)
dommy	骰子工厂
lans2004	突击奇兵 / 雇佣兵 2004 (盗版)
shocktr2	突击骑兵 / 敌后奇兵 - 第二分队
shocktro	突击骑兵 / 敌后奇兵 (第1套)
shocktra	突击骑兵 / 敌后奇兵 (第2套)
drgnbstr	屠龙记
saturn	土星
toppyrap	兔与龟
pushmans	推石超人 (Sammy 授权)
pushman	推石超人 (韩国版, 第1套)
pushmana	推石超人 (韩国版, 第2套)
bagman	推销员
bagmanmc	推销员 (盗版 Moon Cresta 硬件)
dynwar	吞食天地 (美版 第1套)
dynwaru	吞食天地 (美版 第2套)
dynwarj	吞食天地 (日版)
wofj	吞食天地 II - 赤壁之战 (日版 921031)
drtoppelu	托比博士探险队 (美版)
drtoppelj	托比博士探险队 (日版)
drtoppel	托比博士探险队 (世界版)
esckidsj	脱线行大运 (日版, 2 Players)
esckids	脱线行大运 (亚洲版, 4 Players)
pow	脱狱 - 战俘 (美版 版本 1)
powj	脱狱 - 战俘 (日版)
hunchbkg	驼背骑士 (Galaxian 硬件)
hunchbak	驼背骑士 (第1套)
hunchbks	驼背骑士 (紧急起飞 硬件)
huncholy	驼背骑士运动会
hncholms	驼背骑士运动会 (紧急起飞 硬件)
zigzag	挖金子 (Galaxian 硬件, 第1套)
zigzag2	挖金子 (Galaxian 硬件, 第2套)
ddungeon	挖掘大冒险
diamond	挖钻石
snapjack	外星小精灵
mutnat	外星游龙
mwalkbl	外星战将 - 麦可杰克森月球漫步 (盗版)
mwalk	外星战将 - 麦可杰克森月球漫步 (第3套, 世界版, FD1094/8751 317-0159)
crush3	顽皮鬼 (Kural - 盗版?)
crush2	顽皮鬼 (Kural Esco - 盗版?)
crush	顽皮鬼 (Kural Samno)
crush4	顽皮鬼 (Kural TWT)
crushs	顽皮鬼 (Sidam 盗版)
crushbl	顽皮鬼 (盗版)
korosuke	顽皮鬼 Korosuke Roller
mbrush	顽皮鬼 Magic Brush
maketrax	顽皮鬼 Make Trax (第1套)
maketrxb	顽皮鬼 Make Trax (第2套)
nmouse	顽皮鼠 (第1套)
nmouseb	顽皮鼠 (第2套)
aceattac	王牌攻击者 (FD1094 317-0059)
aceattaca	王牌攻击者 (日版, 系统 16A, FD1094 317-0060)
rastanu	王者之剑 (美版, 第1套)
rastanu2	王者之剑 (美版, 第2套)
rastsaga1	王者之剑 (日版 Rev 1)
rastsaga	王者之剑 (日版)
rastan	王者之剑 (世界版)
passsht	网球绝招 - 近身攻击 (2 Players, FD1094 317-0080)
passshtj	网球绝招 - 近身攻击 (日版, 4 Players, FD1094 317-0070)
passsht16a	网球绝招 - 近身攻击 (日版, 4 Players, 系统 16A, FD1094 317-0071)
passshta	网球绝招 - 近身攻击 (世界版, 4 Players, FD1094 317-0074)
varthu	威虎战机 - 雷暴行动 (美版 920612)
varthj	威虎战机 - 雷暴行动 (日版 920714)
varthr1	威虎战机 - 雷暴行动 (世界版 920612)
varth	威虎战机 - 雷暴行动 (世界版 920714)
willow	威洛之旅 (美版)
willowj	威洛之旅 (日版, 日语)
willowje	威洛之旅 (日版, 英语)
scotrsht	未来滑车大对决
striv	问答 超级百科
quizdai2	问答 大搜查线 Part 2 - 问答迷侦探 Neo & Geo
qzchikyu	问答 地球防卫军 (日版)
qndream	问答 虹色町的奇迹 (日版 960826)
cworld	问答 卡普空世界 (日版)
cworld2j	问答 卡普空世界 2 (日版 920611)
qcrayon	问答 蜡笔小新 (日版)
quiz18k	问答 诺奇医生诊察室
qjinsei	问答 人生剧场 (日版)
qsangoku	问答 三国志 - 智略的霸者 (日版)
qtono1	问答 信长之野望 (日版)
qtono2	问答 信长之野望 2 全国版 (日版 950123)
qgakumon	问答 学问大抢答 (日版 ver. JA2 Type L)
rocktrv2	问答 音乐摇滚 (Part 2)
quizo	问答奥林匹克 (第1套)
quizhq	问答大本营 (日版)
quizdais	问答大搜查线 - 最后倒计时
qzquest	问答搜查 - 英雄美女物语 (日版)
myherok	我的英雄 (韩国版)
myhero	我的英雄 (美版, 未加密)
cthd2k3a	卧虎藏龙 2003 (盗版 / 第2套)
cthd2003	卧虎藏龙 2003 (盗版)
ct2k3sa	卧虎藏龙 2003 Super Plus 替换版 (盗版)
ct2k3sp	卧虎藏龙 2003 风云 Super Plus (盗版)
garyoret	卧龙列传 (日版)
turpin	乌龟冒险
turtles	乌龟冒险
600	乌龟冒险 600
koshien	呜呼荣光甲子园 (日版)
opwolfb	乌兹冲锋枪 - 野狼行动  (盗版)
opwolf	乌兹冲锋枪 - 野狼行动  (世界版, 第1套)
opwolfa	乌兹冲锋枪 - 野狼行动  (世界版, 第2套)
opwolfu	乌兹冲锋枪 - 野狼行动 (美版)
opwolfj	乌兹冲锋枪 - 野狼行动 (日版)
ganryu	武藏严流记
ganryun	武藏严流记 (C 解密)
nightstru	午夜出击 (美版)
nightstrj	午夜出击 (日版)
nightstr	午夜出击 (世界版)
mrgoemon	五右卫门先生 (日版)
armedf	武装编队
gunbirdk	武装飞鸟 (韩国版)
gunbirdj	武装飞鸟 (日版)
gunbird	武装飞鸟 (世界版)
gunbird2	武装飞鸟 2
heuksun	五子棋 (韩国版)
jpopnics	吸尘器小子 (Nics, 韩国 盗版 狗狗乐园)
tumbleb	吸尘器小子 (盗版 第1套)
tumbleb2	吸尘器小子 (盗版 第2套)
tumblep	吸尘器小子 (世界版)
jumppop	吸尘器小子 2001
bionicc1	希特勒复活 (美版 第1套)
bionicc2	希特勒复活 (美版 第2套)
bionicc	希特勒复活 (欧版)
topsecrt	希特勒复活 (日版)
vhuntjr2	吸血鬼猎人 - 恶魔的复仇 (日版 950302)
vhuntjr1	吸血鬼猎人 - 恶魔的复仇 (日版 950307)
vhuntj	吸血鬼猎人 - 恶魔的复仇 (日版 950316)
sonson	西游记
sonsonj	西游记 (日版)
orlegendca	西游释厄传 (alt ver. 112, 中文基板)
orlegend105k	西游释厄传 (ver. 105, 韩文基板)
orlegend111c	西游释厄传 (ver. 111, 中文基板)
orlegende	西游释厄传 (ver. 112)
orlegendc	西游释厄传 (ver. 112, 中文基板)
orlegend	西游释厄传 (ver. 126)
olds100a	西游释厄传 Super (ver. 100 替换版)
olds100	西游释厄传 Super (ver. 100)
olds	西游释厄传 Super (ver. 101, 韩文基板)
csilverj	锡鲁巴船长 (日版)
csilver	锡鲁巴船长 (世界版)
lizwiz	蜥蜴巫师大作战
flstory	仙境物语
flstoryj	仙境物语 (日版)
cactus	仙人掌 (盗版 仙人掌兄弟)
sabotenb	仙人掌兄弟 (第1套)
sabotenba	仙人掌兄弟 (第2套)
ultraman	咸蛋超人 - 空想特摄系列 (日版)
abscam	小精灵
popeyeman	小精灵 - 大力水手
piranha	小精灵 - 食人鱼
piranhao	小精灵 - 食人鱼 (旧版)
piranhah	小精灵 - 食人鱼 (修改版)
puckmanh	小精灵 (Falcom?)
puckmanf	小精灵 (日版 第1套 加速修改版)
puckman	小精灵 (日版 第1套)
puckmana	小精灵 (日版 第2套)
puckmod	小精灵 (日版 第3套)
gmgalax	小精灵 Galaxian (盗版)
ctrpllrp	小精灵 Hack
hangly	小精灵 Hangly-Man (第1套)
hangly2	小精灵 Hangly-Man (第2套)
hangly3	小精灵 Hangly-Man (第3套)
joyman	小精灵 Joyman
newpuckx	小精灵 New Puck-X
newpuc2	小精灵 Newpuc2 (第1套)
newpuc2b	小精灵 Newpuc2 (第2套)
pacmanbl	小精灵 Pac-Man (Galaxian 硬件, 第1套)
pacmanbla	小精灵 Pac-Man (Galaxian 硬件, 第2套)
pacman	小精灵 Pac-Man (米德威)
pacmanf	小精灵 Pac-Man (米德威, 加速修改版)
pacmod	小精灵 Pac-Man (米德威, 难度加强版)
pacheart	小精灵 Pac-Man (心形)
uopoko	小猫钓鱼 (国际版)
uopokoj	小猫钓鱼 (日版)
starfght	小蜜蜂
tst_galx	小蜜蜂 - 测试版
galturbo	小蜜蜂 - 极速版 (superg hack)
zerotime	小蜜蜂 - 难度加强版
moonaln	小蜜蜂 - 月球异形
galaxianm	小蜜蜂 (Midway 第1套)
galaxianmo	小蜜蜂 (Midway 第2套)
galaxian	小蜜蜂 (Namco 第1套)
galaxiana	小蜜蜂 (Namco 第2套)
galaxiant	小蜜蜂 (Taito)
galaxbsf	小蜜蜂 (盗版)
swarm	小蜜蜂 (盗版?)
moonal2	小蜜蜂 2 - 月球异形 2
moonal2b	小蜜蜂 2 - 月球异形 2 (旧版)
kamakazi3	小蜜蜂 III (superg hack)
galap1	小蜜蜂 P1 (galaxiana hack)
galap4	小蜜蜂 P4 (hack)
galapx	小蜜蜂 PX (moonaln hack)
flicky	小鸟妃奇 (128k 版本, 系统 2, 315-5051)
flickys2	小鸟妃奇 (128k 版本, 系统 2, 未加密)
flickyo	小鸟妃奇 (64k 版本, 系统 1, 315-5051, 第1套)
flickys1	小鸟妃奇 (64k 版本, 系统 1, 315-5051, 第2套)
ladybug	小瓢虫
ladybugb	小瓢虫 (盗版 第1套)
ladybgb2	小瓢虫 (盗版 第2套)
cps1frog	小青蛙 (CPS-1)
pgmfrog	小青蛙 (Homebrew)
ngfrog	小青蛙 (Neo Geo)
legendos	小拳王
marukodq	小丸子问答
turpins	小乌龟 (盗版 紧急起飞 硬件)
dingo	小熊流浪记
tknight	邪城风云
wildfang	邪城风云 / Tecmo 骑士
yesnoj	心电图
matrim	新豪血寺一族 - 斗婚
matrimbl	新豪血寺一族 - 斗婚 (盗版)
matrimnd	新豪血寺一族 - 斗婚 (完全解密)
simpsons2pj	辛普森家庭 (2 Players 日版)
simpsons2p	辛普森家庭 (2 Players 世界版, 第1套)
simpsons2p2	辛普森家庭 (2 Players 世界版, 第2套)
simpsons2pa	辛普森家庭 (2 Players 亚洲版)
simpsons	辛普森家庭 (4 Players 世界版, 第1套)
simpsons4pa	辛普森家庭 (4 Players 世界版, 第2套)
newsin7	新辛巴达 7
gforce2	星际大争霸 2
gforce2j	星际大争霸 2 (日版)
starjack	星际母舰 (Sega)
starjacks	星际母舰 (Stern)
fx	星际任务
gtstarb1	星球守护者 (盗版 第1套)
gtstarb2	星球守护者 (盗版 第2套)
getstar	星球守护者 (美版)
reguluso	星球战车 (315-5033)
regulus	星球战车 (315-5033, Rev A.)
regulusu	星球战车 (未加密)
zupapa	星星大战!
zupapan	星星大战! (C 解密)
quarteta	星战四人组 (8751 315-5194)
quartet	星战四人组 (Rev A, 8751 315-5194)
quartet2	星战四人组 2 (8751 317-0010)
quartet2a	星战四人组 2 (未保护版)
martmastc	形意拳 (ver. 101, 中文基板)
martmast	形意拳 (ver. 102)
martmast102c	形意拳 (ver. 102, 中文基板)
zerozone	性感宝石方块
funybubl	性感谜球回路
funybublc	性感谜球回路 (Comad 版本)
luctoday	幸运日
socbrawl	喧哗足球 / 机器人足球 (第1套)
socbrawla	喧哗足球 / 机器人足球 (第2套)
gururin	旋转方块
hotdogst	眩之风暴 (国际版)
snowbrosd	雪人兄弟 - 尼克和汤姆 (Dooyong 许可)
wintbob	雪人兄弟 - 尼克和汤姆 (盗版)
snowbros	雪人兄弟 - 尼克和汤姆 (第1套)
snowbrosa	雪人兄弟 - 尼克和汤姆 (第2套)
snowbrosb	雪人兄弟 - 尼克和汤姆 (第3套)
snowbrosc	雪人兄弟 - 尼克和汤姆 (第4套)
snowbrosj	雪人兄弟 - 尼克和汤姆 (日版)
snowbro2	雪人兄弟 2 - With New Elves
snowbros3	雪人兄弟 3 - 不可思议的冒险
asurabld	血剑王朝 - 魔刃降临 (日版)
asurabus	血剑王朝 2 - 永恒的战士 (日版)
gardia	巡弋飞艇 (317-0006)
atlantisb	亚特兰蒂斯大作战 (盗版)
atlantis	亚特兰蒂斯大作战 (第1套)
atlantis2	亚特兰蒂斯大作战 (第2套)
cobracomj	眼睛蛇指令 (日版)
cobracom	眼睛蛇指令 (世界版 校正版 5)
sunaq	阳光 问答 6000 学院 (940620-6)
joyjoy	阳光方块
mstworld	妖怪世界
rockduck	摇摆鸭子 (工程版?)
tharrier	鹞鹰战机
tharrierj	鹞鹰战机 (日版)
mustangs	野马战机 (25th May. 1990 / Seoul Trading)
mustang	野马战机 (25th May. 1990)
mustangb2	野马战机 (TAB 奥地利 盗版)
mustangb	野马战机 (盗版)
beast	野兽之瞳 (Homebrew, 没有声音)
wjammers	野外排球 / 超级飞碟球
burglarx	夜盗 X
dblpoint	夜上海
dblpointd	夜上海 (东京电子, 盗版?)
f1gp	一级方程式 GP 大赛
f1gp2	一级方程式 GP 大赛 2
f1dream	一级方程式梦语
f1dreamb	一级方程式梦语 (盗版)
fncywld	异想世界 - 地球的危机
extrmatnu	异星毁灭者 (美版)
extrmatnj	异星毁灭者 (日版)
extrmatn	异星毁灭者 (世界版)
aliensu	异形 (美版)
aliensj	异形 (日版 第1套)
aliensj2	异形 (日版 第2套)
aliens	异形 (世界版 第1套)
aliens2	异形 (世界版 第2套)
aliens3	异形 (世界版 第3套)
aliensa	异形 (亚洲版)
avspu	异形 对 铁血战士 (美版 940520)
avspd	异形 对 铁血战士 (欧洲版 940520 凤凰版) (盗版)
avsp	异形 对 铁血战士 (欧洲版 940520)
avspj	异形 对 铁血战士 (日版 940520)
avsph	异形 对 铁血战士 (西班牙版 940520)
avspa	异形 对 铁血战士 (亚洲版 940520)
searcharu	异型大作战 (美版)
searcharj	异型大作战 (日版)
searchar	异型大作战 (世界版)
astormj	异形风暴 (第1套, 日版, 2 Players, FD1094 317-0146)
astormu	异形风暴 (第2套, 美版, 3 Players, FD1094 317-0147)
astorm3	异形风暴 (第3套, 世界版, 3 Players, FD1094 317-0148)
astorm	异形风暴 (第4套, 2 Players, FD1094 317-?)
aliensynjo	异形入侵 (第1套, 日版, 旧, 系统 16A, FD1089A 317-0033)
aliensyn2	异形入侵 (第2套, 系统 16A, FD1089A 317-0033)
aliensyn3	异形入侵 (第3套, 系统 16B, FD1089A 317-0033)
aliensyn	异形入侵 (第4套, 系统 16B, 未保护版)
aliensyn5	异形入侵 (第5套, 系统 16A, FD1089B 317-0037)
aliensynj	异形入侵 (第6套, 日版, 新, 系统 16B, FD1089A 317-0033)
outzone	异域战将 (第1套)
outzonea	异域战将 (第2套)
outzoneb	异域战将 (第3套, 工程版?)
outzonec	异域战将 (第4套)
outzoned	异域战将 (第5套)
bballs	益智弹跳球
moremore	益智迷你游戏
moremorp	益智迷你游戏 加强版
nmg5	益智五合一
nmg5e	益智五合一 (早期版)
4in1boot	益智游戏王 (includes bootleg of Snow Bros.)
lwingsb	翼人 (盗版)
lwings	翼人 (美版 第1套)
lwings2	翼人 (美版 第2套)
lwingsj	翼人 (日版)
sonicbom	音速轰炸机 (FD1094 317-0053)
bankp	银行惊魂记
spacempr	银河帝国 (盗版)
uniwars	银河帝国的反击
skyraidr	银河帝国的反击 - 太空入侵
gteikoku	银河帝国的反击 - 太空战斗
spacbatt	银河帝国的反击 - 太空战斗 (盗版 第1套)
spacbat2	银河帝国的反击 - 太空战斗 (盗版 第2套)
gteikokb	银河帝国的反击 (盗版 第1套)
gteikob2	银河帝国的反击 (盗版 第2套)
galaxyfg	银河快打 / 星系格斗
ginganin	银河任侠传 (第1套)
ginganina	银河任侠传 (第2套)
raflesia	银河系战机 (315-5162)
vimana	银河战机
vimanan	银河战机 (Nova Apparate GMBH & Co)
vimana1	银河战机 (旧版)
metmqstr	隐忍 (国际版)
nmaster	隐忍 (日版)
ltorb1	印第安娜琼斯 (050717, Homebrew)
shdancer1	影舞者 (第1套)
shdancerj	影舞者 (第2套, 日版)
shdancer	影舞者 (第3套, 美版)
lkage	影子传说
lkageb	影子传说 (盗版 第1套)
lkageb2	影子传说 (盗版 第2套)
lkageb3	影子传说 (盗版 第3套)
lkageo	影子传说 (旧版 第1套)
lkageoo	影子传说 (旧版 第2套)
tturfu	硬汉 (第1套, 美版, 8751 317-0099)
tturf	硬汉 (第2套, 日版, 8751 317-0104)
bloodbro	勇士们 - 血兄弟 (第1套)
bloodbroa	勇士们 - 血兄弟 (第2套)
androdun	勇者之击
yuyugogo	悠悠问答 GO! GO! (日版)
wmatch	游泳大赛 (315-5064)
cavenger	宇宙复仇者
abcop	宇宙骑警 (FD1094 317-0169b)
vulcan	宇宙巡航舰 (新版)
gradius2a	宇宙巡航舰 II (日版 旧版)
gradius2b	宇宙巡航舰 II (日版 老版)
gradius2	宇宙巡航舰 II (日版 新版)
gradius3	宇宙巡航舰 III (日版)
gradius3e	宇宙巡航舰 III (世界版 ?)
gradius3a	宇宙巡航舰 III (亚洲版)
guwange	狱门山物语 (日版, Master Ver. 99/06/24)
myangel	育婴问答 亲亲小宝贝 (日版)
myangel2	育婴问答 亲亲小宝贝 2 (日版)
gensitou	原始岛
prehisleu	原始岛 (美版)
prehisle	原始岛 (世界版)
preisle2	原始岛 2
preisl2n	原始岛 2 (C 解密)
bcstry	原始人梦语 (第1套)
bcstrya	原始人梦语 (第2套)
knghtsha	圆桌骑士 (911127 盗版 第3套)
knightsh	圆桌骑士 (盗版 / hack)
knightsu	圆桌骑士 (美版 911127)
knightsj	圆桌骑士 (日版 911127)
knights	圆桌骑士 (世界版 911127)
chelnovu	原子超人 (美版)
chelnovj	原子超人 (日版)
chelnov	原子超人 (世界版)
dquizgo	约会问答大作战 (韩国版)
mooncrst	月冠登陆艇 - 三台合体 (日本物产)
mooncrstg	月冠登陆艇 (Gremlin)
mooncmw	月冠登陆艇 (Moon Cresta 盗版)
mooncrsb	月冠登陆艇 (盗版 第1套)
mooncrs2	月冠登陆艇 (盗版 第2套)
mooncrs3	月冠登陆艇 (盗版 第3套)
fantazia	月冠登陆艇 (盗版?)
eagle	月冠登陆艇 (第1套)
eagle2	月冠登陆艇 (第2套)
eagle3	月冠登陆艇 (第3套)
mooncrsto	月冠登陆艇 (日本物产, 旧版)
mooncrstu	月冠登陆艇 (日本物产, 未加密版)
mooncrgx	月冠登陆艇 (小蜜蜂 硬件)
spctbird	月冠登陆艇 Fortrek
smooncrs	月冠登陆艇 Super
moonqsr	月球类星体 - 三台合体
moonwar	月球战争
moonwara	月球战争 (旧版)
driveout	越野赛车
driftout	越野赛车 (日版)
nam1975	越战 - 1975
bombkick	炸弹脚力
bombjack	炸弹杰克 (第1套)
bjtwin	炸弹杰克 (第1套)
bombjack2	炸弹杰克 (第2套)
bjtwina	炸弹杰克 (第2套)
neobombe	炸弹人: Neo 机皇版
panicbom	炸弹人方块
mrtnt	炸药先生
gorkans	炸药先生 Gorkans
bullet	战场雄兵 (FD1094 317-0041)
commandoj	战场之狼
commandob	战场之狼 (盗版)
sinvasnb	战场之狼 (盗版)
commandou	战场之狼 (美版)
sinvasn	战场之狼 (欧洲版)
commando	战场之狼 (世界版)
mercsu	战场之狼 II (美版 900302)
mercsua	战场之狼 II (美版 900608)
mercsj	战场之狼 II (日版 900302)
mercs	战场之狼 II (世界版 900302)
triplep	占地为王
knockout	占地为王 Knock Out!!
cyberlip	战斗边缘
batcird	战斗回路 (欧洲版 970319 凤凰版) (盗版)
batcir	战斗回路 (欧洲版 970319)
batcirj	战斗回路 (日版 970319)
batcira	战斗回路 (亚洲版 970319)
aquajackj	战斗快艇 - 杰克小子 (日版)
aquajack	战斗快艇 - 杰克小子 (世界版)
afighter	战斗任务 (FD1089A 317-0018)
combh	战斗神鹰
bkraidu	战斗翔鹰 - 无限版本 (美版) (Tue Jun 8 1999)
bkraiduj	战斗翔鹰 - 无限版本 (日版) (Tue Jun 8 1999)
bkraidj	战斗翔鹰 (日版) (Wed Apr 7 1999)
gyrodinec	战斗直升机
gyrodine	战斗直升机 (泰德)
goldnaxe1	战斧 (第1套, 世界版, FD1094 317-0110)
goldnaxe2	战斧 (第2套, 美版, 8751 317-0112)
goldnaxe3	战斧 (第3套, 世界版, FD1094 317-0120)
goldnaxej	战斧 (第4套, 日版, FD1094 317-0121)
goldnaxeu	战斧 (第5套, 美版, FD1094 317-0122)
goldnaxe	战斧 (第6套, 美版, 8751 317-123A)
sengoku	战国传承 (第1套)
sengokh	战国传承 (第2套)
sengoku2	战国传承 2
sengoku3	战国传承 3 / 战国传承 2001
sngoku3n	战国传承 3 / 战国传承 2001 (C 解密)
sngkace	战国世纪 (日版)
samuraia	战国世纪 (世界版)
tengaij	战国之刃
tengai	战国之刃 (世界版)
unsquad	战区 88 (美版)
area88	战区 88 (日版)
fswords	战士之剑 (韩国版 侍魂 III)
esprade	长空超少年 (国际版, Ver. 98/04/22)
espradejo	长空超少年 (日版, Ver. 98/04/14)
espradej	长空超少年 (日版, Ver. 98/04/21)
pass	长舌超人
speedspn	真实乒乓球
samsho2k	真侍魂 (韩国版 侍魂 II)
gaia	征战者
rescue	拯救直升机
aponow	拯救直升机 Apocaljpse Now
thndrbld1	直升机 (豪华版/standing, 未保护版)
thndrbld	直升机 (直立型, FD1094 317-0056)
ngem2k	智力符号 2000 (Beta 060118, Homebrew)
silkworm	中东战争 (第1套)
silkworm2	中东战争 (第2套)
drgw2c	中国龙 II (ver. 100C, 中国版)
drgw2j	中国龙 II (ver. 100J, 日版)
drgw2	中国龙 II (ver. 110X, 海外版)
chukataiu	中华大仙 (美版)
chukataij	中华大仙 (日版)
chukatai	中华大仙 (世界版)
irrmaze	终极电流急急棒
hsf2	终极街头霸王 II: 十五周年纪念版 (美版 040202)
hsf2j	终极街头霸王 II: 十五周年纪念版 (日版 031222)
hsf2d	终极街头霸王 II: 十五周年纪念版 (亚洲版 040202 凤凰版) (盗版)
hsf2a	终极街头霸王 II: 十五周年纪念版 (亚洲版 040202)
uballoon	终极气球
lresort	终极任务
hwchamp	重量拳击
pootan	猪仔射狼
pooyan	猪仔射狼
pooyans	猪仔射狼 (Stern)
cuebrickj	砖块拼图大考验 (日版)
cuebrick	砖块拼图大考验 (世界版 版本 D)
armorcar	装甲车 (第1套)
armorcar2	装甲车 (第2套)
metrocrs	追赶跑跳碰 (第1套)
metrocrsa	追赶跑跳碰 (第2套)
chasehqu	追踪 H.Q. (美版)
chasehqj	追踪 H.Q. (日版)
chasehq	追踪 H.Q. (世界版)
woodpeck	啄木鸟 (第1套)
kodure	子连狼 (日版)
ozon1	自走炮 1
alpham2	组合战机 ASO II - 最后的守护神
diggerma	钻地先生
crimfght	罪恶战士 (美版 4 players)
crimfghtj	罪恶战士 (日版 2 Players)
crimfght2	罪恶战士 (世界版 2 Players)
vendettaj	罪恶战士 2 (日版 2 Players ver. P)
vendetta2p	罪恶战士 2 (世界版 2 Players ver. W)
vendettar	罪恶战士 2 (世界版 4 Players ver. R)
vendetta	罪恶战士 2 (世界版 4 Players ver. T)
vendetta2pd	罪恶战士 2 (亚洲版 2 Players ver. D)
vendetta2pu	罪恶战士 2 (亚洲版 2 Players ver. U)
lastsold	最后的战士 (韩国版 月华剑士)
kyustrkr	最后足球
finalbu	最终打击 (美版)
finalbj	最终打击 (日版)
finalb	最终打击 (世界版)
lastmisno	最终任务 (美版 校正版 5)
lastmisn	最终任务 (美版 校正版 6)
lastmisnj	最终任务 (日版)
fstarfrc	最终星际武力 (美版)
fstarfrcj	最终星际武力 (日版)